,date,duration_hours,total_sleep_minutes,total_time_in_bed,start_time,deep_minutes,light_minutes,rem_minutes,wake_minutes
0,2018-01-01,7.75,415,465,2018-01-01T04:37:30.000,64,245,106,50
1,2018-01-02,9.45,506,567,2018-01-01T22:47:30.000,55,328,123,61
2,2018-01-03,7.566666666666666,404,454,2018-01-03T00:06:30.000,63,234,107,50
3,2018-01-04,8.333333333333334,458,500,2018-01-04T00:30:00.000,120,217,121,42
4,2018-01-05,8.483333333333333,448,509,2018-01-04T23:58:30.000,75,288,85,61
5,2018-01-28,9.016666666666667,481,541,2018-01-28T01:24:30.000,85,294,102,60
6,2018-01-29,8.333333333333334,459,500,2018-01-28T22:52:30.000,68,276,115,41
7,2018-01-30,7.666666666666667,421,460,2018-01-29T23:43:30.000,51,287,83,39
8,2018-01-31,7.483333333333333,402,449,2018-01-30T23:48:00.000,72,214,116,47
9,2018-02-02,7.7,421,462,2018-02-01T23:37:00.000,131,205,85,41
10,2018-02-03,8.05,444,483,2018-02-03T00:52:30.000,110,240,94,39
11,2018-02-04,8.1,445,486,2018-02-04T00:37:30.000,82,230,133,41
12,2018-02-05,7.883333333333334,413,473,2018-02-04T23:41:30.000,86,216,111,60
13,2018-02-06,7.383333333333334,396,443,2018-02-06T00:08:00.000,114,177,105,47
14,2018-02-07,7.833333333333333,416,470,2018-02-06T23:45:30.000,89,257,70,54
15,2018-02-08,7.666666666666667,418,460,2018-02-07T23:48:30.000,76,211,131,42
16,2018-02-09,7.1,384,426,2018-02-09T00:26:00.000,77,189,118,42
17,2018-02-10,5.783333333333333,310,347,2018-02-10T03:17:00.000,75,187,48,37
18,2018-02-11,8.766666666666667,461,526,2018-02-11T01:13:00.000,115,241,105,65
19,2018-02-12,8.033333333333333,421,482,2018-02-11T23:36:30.000,73,222,126,61
20,2018-02-13,8.183333333333334,434,491,2018-02-12T23:51:00.000,84,246,104,57
21,2018-02-14,7.7,405,462,2018-02-14T00:02:00.000,65,253,87,57
22,2018-02-16,8.383333333333333,431,503,2018-02-16T00:01:30.000,93,236,102,72
23,2018-02-17,6.083333333333333,310,365,2018-02-17T02:28:00.000,76,194,40,55
24,2018-02-18,9.233333333333333,492,554,2018-02-18T02:04:30.000,77,315,100,62
25,2018-02-19,8.116666666666667,437,487,2018-02-18T23:27:00.000,53,278,106,50
26,2018-02-20,7.2,380,432,2018-02-20T00:27:00.000,112,196,72,52
27,2018-02-21,7.6,411,456,2018-02-21T00:02:00.000,71,245,95,45
28,2018-02-25,8.733333333333333,481,524,2018-02-25T00:51:30.000,96,264,121,43
29,2018-02-26,7.95,444,477,2018-02-25T23:29:00.000,63,269,112,33
30,2018-02-27,7.433333333333334,374,446,2018-02-26T23:37:30.000,71,210,93,72
31,2018-03-01,7.333333333333333,402,440,2018-02-28T23:34:00.000,103,191,108,38
32,2018-03-02,8.466666666666667,464,508,2018-03-01T23:00:00.000,99,247,118,44
33,2018-03-03,9.483333333333333,487,569,2018-03-03T00:37:30.000,92,278,117,82
34,2018-03-04,10.05,517,603,2018-03-03T23:52:00.000,81,299,137,86
35,2018-03-05,7.866666666666666,424,472,2018-03-04T23:21:00.000,80,242,102,48
36,2018-03-06,7.716666666666667,425,463,2018-03-05T23:34:30.000,77,241,107,38
37,2018-03-07,6.1,335,366,2018-03-07T01:53:30.000,84,183,68,31
38,2018-03-09,7.2,380,432,2018-03-08T23:48:00.000,65,276,39,52
39,2018-03-10,6.6,347,396,2018-03-10T01:23:00.000,80,194,73,49
40,2018-03-11,9.183333333333334,446,551,2018-03-10T23:33:00.000,88,267,91,45
41,2018-03-12,8.1,446,486,2018-03-11T23:21:30.000,75,258,113,40
42,2018-03-13,7.566666666666666,402,454,2018-03-13T00:50:30.000,60,251,91,52
43,2018-03-14,6.683333333333334,355,401,2018-03-14T00:17:30.000,68,206,81,46
44,2018-03-15,7.85,415,471,2018-03-14T23:22:30.000,88,216,111,56
45,2018-03-16,8.116666666666667,410,487,2018-03-15T23:30:30.000,101,273,36,77
46,2018-03-17,4.483333333333333,236,269,2018-03-17T03:52:00.000,49,150,37,33
47,2018-03-18,7.033333333333333,377,422,2018-03-18T02:41:30.000,87,180,110,45
48,2018-03-19,7.8,410,468,2018-03-18T23:13:00.000,77,241,92,58
49,2018-03-20,9.15,465,549,2018-03-19T23:18:00.000,85,287,93,84
50,2018-03-21,10.05,552,603,2018-03-21T01:05:30.000,120,325,107,51
51,2018-03-22,8.516666666666667,449,511,2018-03-21T23:30:00.000,73,268,108,62
52,2018-03-23,7.733333333333333,406,464,2018-03-22T23:17:30.000,87,233,86,58
53,2018-03-24,8.3,430,498,2018-03-24T00:54:00.000,85,242,103,68
54,2018-03-25,7.533333333333333,406,452,2018-03-25T01:49:30.000,70,252,84,46
55,2018-03-26,6.966666666666667,357,418,2018-03-26T00:29:00.000,68,197,92,61
56,2018-03-27,7.583333333333333,410,455,2018-03-27T00:20:30.000,110,166,134,45
57,2018-03-28,7.816666666666666,413,469,2018-03-27T23:39:00.000,107,213,93,56
58,2018-03-29,8.483333333333333,460,509,2018-03-28T23:14:30.000,123,246,91,49
59,2018-03-30,7.3,405,438,2018-03-30T00:09:30.000,90,182,133,33
60,2018-03-31,9.316666666666666,503,559,2018-03-30T23:39:00.000,123,241,139,56
61,2018-04-01,5.8,314,348,2018-04-01T03:40:30.000,66,182,66,34
62,2018-04-02,8.016666666666667,438,481,2018-04-01T23:19:00.000,126,176,136,43
63,2018-04-03,8.166666666666666,440,490,2018-04-02T22:58:30.000,72,255,113,50
64,2018-04-04,7.4,402,444,2018-04-04T00:08:00.000,79,228,95,42
65,2018-04-05,7.966666666666667,425,478,2018-04-04T23:29:00.000,106,204,115,53
66,2018-04-06,7.916666666666667,429,475,2018-04-05T23:44:30.000,88,277,64,46
67,2018-04-07,6.8,348,408,2018-04-07T01:53:00.000,64,210,74,60
68,2018-04-08,9.216666666666667,491,553,2018-04-08T00:09:30.000,92,295,104,62
69,2018-04-09,7.716666666666667,407,463,2018-04-08T23:46:00.000,92,214,101,56
70,2018-04-10,7.616666666666666,415,457,2018-04-09T23:50:00.000,111,222,82,42
71,2018-04-11,7.95,423,477,2018-04-10T23:25:00.000,84,256,83,54
72,2018-04-12,8.883333333333333,470,533,2018-04-11T23:05:00.000,105,269,96,63
73,2018-04-13,7.95,402,477,2018-04-12T23:30:00.000,74,243,85,75
74,2018-04-14,6.783333333333333,367,407,2018-04-14T01:55:00.000,91,172,104,40
75,2018-04-15,10.3,520,618,2018-04-14T22:58:00.000,69,318,133,98
76,2018-04-16,8.183333333333334,438,491,2018-04-15T23:23:00.000,45,306,87,53
77,2018-04-17,8.166666666666666,429,490,2018-04-16T23:38:30.000,83,237,109,61
78,2018-04-18,7.45,409,447,2018-04-18T00:08:30.000,59,268,82,38
79,2018-04-19,7.416666666666667,395,445,2018-04-18T23:34:00.000,76,220,99,50
80,2018-04-20,7.35,373,441,2018-04-20T00:07:30.000,67,270,36,68
81,2018-04-21,6.7,358,402,2018-04-21T01:17:00.000,81,201,76,44
82,2018-04-22,6.05,311,363,2018-04-22T03:06:00.000,64,176,71,52
83,2018-04-23,8.8,475,528,2018-04-22T22:55:00.000,55,302,118,53
84,2018-04-24,8.983333333333333,485,539,2018-04-23T22:54:00.000,96,278,111,54
85,2018-04-25,7.733333333333333,417,464,2018-04-24T23:38:00.000,87,238,92,47
86,2018-04-26,8.733333333333333,441,524,2018-04-25T23:42:00.000,57,287,97,83
87,2018-04-27,8.083333333333334,436,485,2018-04-26T23:31:00.000,89,247,100,49
88,2018-04-28,7.483333333333333,404,449,2018-04-28T01:53:00.000,82,224,98,45
89,2018-04-29,7.466666666666667,406,448,2018-04-29T02:22:00.000,82,259,65,42
90,2018-04-30,8.183333333333334,443,491,2018-04-29T23:34:00.000,64,288,91,48
91,2018-05-01,7.85,435,471,2018-04-30T23:48:00.000,108,230,97,36
92,2018-05-02,7.233333333333333,379,434,2018-05-02T00:25:30.000,42,246,91,55
93,2018-05-03,8.216666666666667,440,493,2018-05-02T23:18:00.000,70,278,92,53
94,2018-05-04,7.25,373,435,2018-05-04T00:30:30.000,98,217,58,62
95,2018-05-05,7.416666666666667,383,445,2018-05-05T01:40:00.000,71,245,67,62
96,2018-05-06,6.716666666666667,359,403,2018-05-06T03:25:30.000,79,218,62,44
97,2018-05-07,8.216666666666667,434,493,2018-05-06T23:05:00.000,88,260,86,59
98,2018-05-08,7.833333333333333,413,470,2018-05-07T23:43:00.000,79,223,111,57
99,2018-05-09,7.5,395,450,2018-05-09T00:18:00.000,85,224,86,55
100,2018-05-10,8.75,468,525,2018-05-09T23:24:00.000,111,263,94,57
101,2018-05-11,8.316666666666666,426,499,2018-05-10T23:51:00.000,87,245,94,73
102,2018-05-12,8.966666666666667,478,538,2018-05-12T01:03:00.000,97,271,110,60
103,2018-05-13,8.083333333333334,445,485,2018-05-13T00:53:30.000,122,243,80,40
104,2018-05-14,9.066666666666666,444,544,2018-05-13T22:24:00.000,57,286,101,100
105,2018-05-15,7.55,402,453,2018-05-14T23:58:00.000,87,230,85,51
106,2018-05-16,8.6,456,516,2018-05-15T23:00:00.000,83,276,97,60
107,2018-05-17,7.683333333333334,415,461,2018-05-17T00:07:30.000,74,252,89,46
108,2018-05-18,7.95,431,477,2018-05-17T23:39:00.000,90,249,92,46
109,2018-05-19,7.983333333333333,412,479,2018-05-19T01:28:00.000,59,317,36,67
110,2018-05-20,7.183333333333334,379,431,2018-05-20T02:58:00.000,56,256,67,52
111,2018-05-21,8.35,452,501,2018-05-20T23:37:00.000,99,236,117,49
112,2018-05-22,8.05,436,483,2018-05-21T23:46:00.000,114,227,95,47
113,2018-05-23,8.1,416,486,2018-05-22T23:33:00.000,76,272,68,70
114,2018-05-24,8.2,433,492,2018-05-23T23:43:00.000,82,261,90,59
115,2018-05-25,8.45,430,507,2018-05-25T00:03:00.000,99,246,85,77
116,2018-05-26,7.85,415,471,2018-05-26T02:02:00.000,89,253,73,56
117,2018-05-27,8.983333333333333,468,539,2018-05-27T00:56:00.000,88,291,89,71
118,2018-05-28,6.9,381,414,2018-05-28T01:48:30.000,82,220,79,33
119,2018-05-29,8.05,423,483,2018-05-28T23:46:00.000,64,293,66,60
120,2018-05-30,8.083333333333334,430,485,2018-05-30T00:15:30.000,101,233,96,55
121,2018-05-31,7.133333333333334,396,428,2018-05-31T00:08:00.000,94,221,81,32
122,2018-06-01,8.083333333333334,435,485,2018-06-01T03:49:30.000,86,221,128,50
123,2018-06-03,6.866666666666666,365,412,2018-06-03T05:03:00.000,90,210,65,47
124,2018-06-04,8.55,449,513,2018-06-03T23:27:30.000,72,272,105,64
125,2018-06-05,7.516666666666667,397,451,2018-06-05T00:04:30.000,99,200,98,54
126,2018-06-06,8.233333333333333,433,494,2018-06-05T23:44:30.000,98,236,99,61
127,2018-06-07,8.616666666666667,439,517,2018-06-06T23:33:00.000,79,267,93,78
128,2018-06-08,7.5,406,450,2018-06-07T23:07:00.000,109,197,100,44
129,2018-06-09,8.266666666666667,436,496,2018-06-09T02:05:00.000,54,301,81,60
130,2018-06-10,7.25,373,435,2018-06-10T01:23:30.000,84,215,74,62
131,2018-06-11,8.866666666666667,474,532,2018-06-10T22:49:00.000,114,251,109,58
132,2018-06-12,7.833333333333333,417,470,2018-06-11T23:52:00.000,62,291,64,53
133,2018-06-13,8.0,427,480,2018-06-12T23:37:30.000,72,248,107,53
134,2018-06-14,7.633333333333334,400,458,2018-06-13T23:57:00.000,82,237,81,58
135,2018-06-15,7.0,368,420,2018-06-15T00:04:30.000,77,226,65,52
136,2018-06-16,8.416666666666666,463,505,2018-06-15T23:46:00.000,145,197,121,42
137,2018-06-17,8.316666666666666,449,499,2018-06-17T01:02:30.000,90,240,119,50
138,2018-06-18,9.083333333333334,438,545,2018-06-17T22:08:00.000,50,317,71,107
139,2018-06-19,7.333333333333333,388,440,2018-06-19T00:02:30.000,97,213,78,52
140,2018-06-20,8.25,429,495,2018-06-19T23:27:00.000,108,205,116,66
141,2018-06-21,8.416666666666666,443,505,2018-06-20T23:35:00.000,112,223,108,62
142,2018-06-22,7.016666666666667,369,421,2018-06-22T00:32:00.000,111,224,34,52
143,2018-06-23,7.9,427,474,2018-06-23T00:09:00.000,100,224,103,47
144,2018-06-24,7.533333333333333,406,452,2018-06-24T00:35:00.000,77,249,80,46
145,2018-06-25,9.083333333333334,501,545,2018-06-24T23:06:00.000,130,272,99,44
146,2018-06-26,8.466666666666667,437,508,2018-06-25T23:34:30.000,75,288,74,71
147,2018-06-27,7.55,418,453,2018-06-26T23:54:00.000,84,222,112,35
148,2018-06-28,7.783333333333333,427,467,2018-06-27T23:42:00.000,62,303,62,40
149,2018-06-29,6.966666666666667,380,418,2018-06-29T00:05:30.000,82,180,118,38
150,2018-06-30,7.0,374,420,2018-06-30T01:07:00.000,86,237,51,46
151,2018-07-01,6.6,362,396,2018-07-01T04:41:00.000,79,180,103,34
152,2018-07-02,8.166666666666666,439,490,2018-07-01T23:45:00.000,73,302,64,51
153,2018-07-03,7.55,395,453,2018-07-03T00:11:00.000,80,206,109,58
154,2018-07-04,7.216666666666667,397,433,2018-07-04T01:07:00.000,86,196,115,36
155,2018-07-05,7.883333333333334,411,473,2018-07-04T23:33:00.000,77,241,93,62
156,2018-07-06,6.766666666666667,371,406,2018-07-06T00:12:00.000,85,233,53,35
157,2018-07-07,7.7,414,462,2018-07-07T01:48:00.000,68,249,97,48
158,2018-07-08,9.333333333333334,495,560,2018-07-08T01:30:30.000,95,302,98,65
159,2018-07-09,6.583333333333333,353,395,2018-07-09T00:49:30.000,92,174,87,42
160,2018-07-10,8.316666666666666,452,499,2018-07-09T23:31:00.000,83,241,128,47
161,2018-07-11,7.4,404,444,2018-07-11T00:55:30.000,75,240,89,40
162,2018-07-12,7.583333333333333,401,455,2018-07-12T00:19:00.000,93,240,68,54
163,2018-07-13,7.95,412,477,2018-07-12T23:34:00.000,66,248,98,65
164,2018-07-14,8.183333333333334,430,491,2018-07-14T01:57:00.000,79,270,81,61
165,2018-07-15,7.65,392,459,2018-07-15T01:28:00.000,49,292,51,67
166,2018-07-16,7.45,374,447,2018-07-15T23:50:30.000,52,280,42,73
167,2018-07-17,6.7,357,402,2018-07-17T01:47:30.000,58,237,62,45
168,2018-07-18,6.35,345,381,2018-07-18T02:47:30.000,56,223,66,36
169,2018-07-19,8.75,470,525,2018-07-19T00:48:00.000,77,293,100,55
170,2018-07-20,7.416666666666667,377,445,2018-07-19T23:52:00.000,115,213,49,68
171,2018-07-21,7.483333333333333,382,449,2018-07-20T23:50:00.000,97,239,46,67
172,2018-07-22,8.983333333333333,486,539,2018-07-22T00:38:30.000,101,250,135,53
173,2018-07-23,8.15,448,489,2018-07-23T01:20:00.000,101,284,63,41
174,2018-07-24,7.4,404,444,2018-07-24T00:17:30.000,73,243,88,40
175,2018-07-25,5.783333333333333,295,347,2018-07-25T01:04:30.000,34,254,7,52
176,2018-07-26,9.55,507,573,2018-07-26T02:23:00.000,117,285,105,66
177,2018-07-27,6.816666666666666,319,409,2018-07-27T01:36:30.000,22,254,43,90
178,2018-07-28,10.6,573,636,2018-07-28T03:35:00.000,89,349,135,63
179,2018-07-29,6.883333333333334,347,413,2018-07-29T06:04:30.000,33,289,25,66
180,2018-07-30,9.566666666666666,513,574,2018-07-30T03:37:00.000,73,302,138,61
181,2018-08-02,8.55,417,513,2018-08-02T02:22:30.000,48,255,114,96
182,2018-08-03,5.483333333333333,300,329,2018-08-03T01:49:30.000,69,157,74,29
183,2018-08-04,8.283333333333333,432,497,2018-08-04T04:53:00.000,82,250,100,65
184,2018-08-05,6.75,364,405,2018-08-05T02:22:30.000,102,185,77,41
185,2018-08-06,3.466666666666667,186,208,2018-08-06T02:55:00.000,38,106,42,22
186,2018-08-07,8.45,454,507,2018-08-06T22:12:00.000,92,257,105,53
187,2018-08-08,8.216666666666667,446,493,2018-08-07T21:58:00.000,98,283,65,47
188,2018-08-09,8.0,427,480,2018-08-08T22:39:00.000,98,247,82,53
189,2018-08-10,7.833333333333333,403,470,2018-08-09T22:37:00.000,91,240,72,67
190,2018-08-11,7.833333333333333,416,470,2018-08-11T00:38:00.000,58,275,83,54
191,2018-08-12,7.7,410,462,2018-08-11T23:39:30.000,79,240,91,52
192,2018-08-13,7.333333333333333,395,440,2018-08-12T23:26:30.000,58,265,72,45
193,2018-08-14,8.85,479,531,2018-08-13T23:08:00.000,95,283,101,52
194,2018-08-15,8.533333333333333,456,512,2018-08-14T22:45:00.000,85,269,102,56
195,2018-08-16,7.733333333333333,424,464,2018-08-15T23:13:00.000,93,211,120,40
196,2018-08-17,6.866666666666666,381,412,2018-08-16T23:39:30.000,78,207,96,31
197,2018-08-20,8.566666666666666,455,514,2018-08-19T22:30:00.000,84,281,90,59
198,2018-08-21,7.433333333333334,393,446,2018-08-20T23:27:00.000,91,228,74,53
199,2018-08-22,8.316666666666666,446,499,2018-08-21T22:48:30.000,93,223,130,53
200,2018-08-23,7.8,430,468,2018-08-22T23:04:00.000,94,216,120,38
201,2018-08-24,7.3,389,438,2018-08-23T23:45:30.000,80,218,91,49
202,2018-08-25,7.5,403,450,2018-08-25T01:16:00.000,98,192,113,47
203,2018-08-26,9.616666666666667,494,577,2018-08-25T22:08:30.000,91,290,113,83
204,2018-08-27,7.75,402,465,2018-08-26T23:29:00.000,56,251,95,63
205,2018-08-28,8.05,432,483,2018-08-27T23:12:00.000,101,256,75,51
206,2018-08-29,7.75,403,465,2018-08-28T23:19:00.000,64,278,61,62
207,2018-08-30,7.05,373,423,2018-08-29T23:57:00.000,74,229,70,50
208,2018-08-31,5.9,318,354,2018-08-31T01:01:00.000,51,210,57,36
209,2018-09-01,7.65,405,459,2018-09-01T01:30:00.000,93,231,81,54
210,2018-09-02,6.55,353,393,2018-09-02T04:29:00.000,65,259,29,40
211,2018-09-05,7.85,431,471,2018-09-04T23:40:00.000,74,243,114,40
212,2018-09-06,7.85,409,471,2018-09-05T23:38:30.000,96,222,91,62
213,2018-09-07,8.8,474,528,2018-09-06T23:28:00.000,93,251,130,54
214,2018-09-08,7.333333333333333,378,440,2018-09-08T00:34:00.000,75,240,63,62
215,2018-09-09,6.6,350,396,2018-09-09T03:22:00.000,57,229,64,46
216,2018-09-11,7.516666666666667,415,451,2018-09-11T00:32:00.000,99,190,126,36
217,2018-09-12,7.45,374,447,2018-09-11T23:55:00.000,86,201,87,73
218,2018-09-13,7.966666666666667,428,478,2018-09-13T00:06:00.000,113,224,91,50
219,2018-09-14,7.2,362,432,2018-09-14T00:42:30.000,85,209,68,70
220,2018-09-15,9.15,486,549,2018-09-14T23:38:30.000,89,311,86,63
221,2018-09-16,8.066666666666666,440,484,2018-09-16T01:03:00.000,105,201,134,44
222,2018-09-17,8.55,461,513,2018-09-16T23:00:30.000,106,220,135,52
223,2018-09-18,7.5,400,450,2018-09-18T00:08:30.000,99,240,61,50
224,2018-09-19,7.9,428,474,2018-09-18T23:32:00.000,78,258,92,46
225,2018-09-20,7.6,388,456,2018-09-20T00:04:00.000,89,223,76,68
226,2018-09-21,7.55,411,453,2018-09-21T00:18:00.000,94,207,110,42
227,2018-09-22,8.033333333333333,429,482,2018-09-22T01:05:00.000,73,258,98,53
228,2018-09-23,5.4,288,324,2018-09-23T06:02:00.000,64,162,62,36
229,2018-09-24,7.75,412,465,2018-09-23T23:29:00.000,60,286,66,53
230,2018-09-25,7.333333333333333,408,440,2018-09-25T00:02:00.000,66,221,121,32
231,2018-09-26,7.9,417,474,2018-09-26T00:08:30.000,94,238,85,57
232,2018-09-27,7.666666666666667,413,460,2018-09-26T23:42:00.000,75,245,93,47
233,2018-09-28,8.316666666666666,437,499,2018-09-27T23:34:00.000,89,278,70,62
234,2018-09-29,8.2,432,492,2018-09-29T00:46:00.000,80,268,84,60
235,2018-09-30,7.45,409,447,2018-09-30T01:57:00.000,106,163,140,38
236,2018-10-01,8.983333333333333,477,539,2018-09-30T22:31:00.000,71,288,118,62
237,2018-10-03,8.283333333333333,454,497,2018-10-02T23:44:30.000,61,333,60,43
238,2018-10-04,7.683333333333334,413,461,2018-10-03T23:56:00.000,64,261,88,48
239,2018-10-05,7.083333333333333,384,425,2018-10-05T00:13:30.000,80,196,108,41
240,2018-10-06,8.316666666666666,440,499,2018-10-06T00:31:00.000,86,245,109,59
241,2018-10-07,6.816666666666666,371,409,2018-10-07T01:54:00.000,73,163,135,38
242,2018-10-10,8.033333333333333,434,482,2018-10-09T23:35:30.000,85,252,97,48
243,2018-10-11,7.883333333333334,426,473,2018-10-10T23:54:30.000,110,192,124,47
244,2018-10-12,7.816666666666666,394,469,2018-10-11T23:48:30.000,99,225,70,75
245,2018-10-13,8.45,446,507,2018-10-13T01:04:00.000,98,254,94,61
246,2018-10-14,8.0,428,480,2018-10-14T01:31:00.000,122,206,100,52
247,2018-10-15,8.166666666666666,433,490,2018-10-14T23:04:30.000,81,255,97,57
248,2018-10-16,6.666666666666667,353,400,2018-10-16T01:27:00.000,68,214,71,47
249,2018-10-19,7.85,422,471,2018-10-18T23:05:30.000,57,316,49,49
250,2018-10-20,7.15,378,429,2018-10-20T02:33:00.000,75,217,86,51
251,2018-10-21,6.933333333333334,361,416,2018-10-21T02:01:00.000,46,251,64,55
252,2018-10-22,7.6,404,456,2018-10-22T00:26:00.000,81,271,52,52
253,2018-10-23,6.85,367,411,2018-10-22T23:45:00.000,69,223,75,44
254,2018-10-24,8.016666666666667,430,481,2018-10-23T23:42:30.000,109,203,118,51
255,2018-10-25,7.116666666666666,372,427,2018-10-25T00:29:30.000,72,257,43,55
256,2018-10-26,7.0,379,420,2018-10-26T00:05:30.000,75,238,66,41
257,2018-10-27,6.95,350,417,2018-10-27T05:03:00.000,53,286,11,67
258,2018-10-28,8.65,468,519,2018-10-28T03:36:30.000,89,255,124,51
259,2018-10-29,7.9,427,474,2018-10-29T00:06:00.000,79,271,77,47
260,2018-10-30,8.6,476,516,2018-10-29T22:55:00.000,71,293,112,40
261,2018-10-31,7.066666666666666,380,424,2018-10-31T00:23:30.000,68,233,79,44
262,2018-11-01,7.933333333333334,439,476,2018-11-01T00:01:30.000,93,215,131,37
263,2018-11-02,8.166666666666666,451,490,2018-11-01T23:49:00.000,62,281,108,39
264,2018-11-03,8.5,454,510,2018-11-03T01:04:30.000,76,280,98,56
265,2018-11-04,6.483333333333333,335,389,2018-11-04T02:40:30.000,76,198,61,54
266,2018-11-05,7.466666666666667,396,448,2018-11-05T00:12:30.000,78,196,122,52
267,2018-11-06,8.433333333333334,415,506,2018-11-05T23:30:30.000,66,299,50,91
268,2018-11-07,7.533333333333333,398,452,2018-11-06T23:58:30.000,73,223,102,54
269,2018-11-08,8.633333333333333,472,518,2018-11-07T23:49:00.000,105,250,117,46
270,2018-11-09,7.45,388,447,2018-11-08T23:55:00.000,108,204,76,59
271,2018-11-10,7.816666666666666,418,469,2018-11-10T00:49:00.000,85,256,77,51
272,2018-11-11,10.516666666666667,581,631,2018-11-10T23:40:00.000,122,290,169,50
273,2018-11-12,7.5,396,450,2018-11-11T23:57:30.000,44,283,69,54
274,2018-11-21,6.95,362,417,2018-11-21T01:27:00.000,88,222,52,55
275,2018-11-22,7.966666666666667,418,478,2018-11-22T01:41:00.000,105,178,135,60
276,2018-11-23,7.95,437,477,2018-11-23T00:31:00.000,96,214,127,40
277,2018-11-24,5.8,315,348,2018-11-24T05:58:00.000,69,177,69,33
278,2018-11-25,6.216666666666667,328,373,2018-11-25T06:27:30.000,62,220,46,45
279,2018-11-26,7.816666666666666,421,469,2018-11-26T00:04:00.000,101,206,114,48
280,2018-11-27,7.35,405,441,2018-11-27T00:43:30.000,84,207,114,36
281,2018-11-28,7.45,392,447,2018-11-28T00:25:30.000,81,245,66,55
282,2018-11-29,8.5,445,510,2018-11-29T00:05:00.000,107,250,88,65
283,2018-12-01,8.183333333333334,442,491,2018-12-01T00:54:00.000,105,207,130,49
284,2018-12-02,7.933333333333334,409,476,2018-12-02T00:54:30.000,95,212,102,67
285,2018-12-03,7.316666666666666,401,439,2018-12-03T00:08:00.000,86,210,105,38
286,2018-12-04,8.216666666666667,429,493,2018-12-03T23:51:00.000,80,257,92,64
287,2018-12-05,7.55,417,453,2018-12-05T00:02:30.000,102,197,118,36
288,2018-12-06,7.4,407,444,2018-12-06T00:12:30.000,116,180,111,37
289,2018-12-07,7.3,408,438,2018-12-07T00:30:00.000,105,189,114,30
290,2018-12-08,6.4,354,384,2018-12-08T02:13:00.000,71,179,104,30
291,2018-12-09,7.85,418,471,2018-12-09T02:24:30.000,100,225,93,53
292,2018-12-14,7.483333333333333,416,449,2018-12-14T00:11:00.000,117,171,128,33
293,2018-12-15,7.683333333333334,416,461,2018-12-15T01:45:00.000,89,205,122,45
294,2018-12-16,7.216666666666667,396,433,2018-12-16T04:01:00.000,86,229,81,37
295,2018-12-17,8.716666666666667,483,523,2018-12-16T22:45:00.000,110,255,118,40
296,2018-12-18,8.183333333333334,436,491,2018-12-17T23:32:30.000,86,279,71,55
297,2018-12-19,7.666666666666667,406,460,2018-12-18T23:53:30.000,95,229,82,54
298,2018-12-20,7.483333333333333,410,449,2018-12-20T00:42:00.000,100,225,85,39
299,2018-12-21,9.416666666666666,509,565,2018-12-21T00:26:00.000,94,317,98,56
300,2018-12-22,9.016666666666667,472,541,2018-12-22T00:50:00.000,121,235,116,69
301,2018-12-23,5.016666666666667,267,301,2018-12-23T03:24:00.000,58,135,74,34
302,2018-12-24,10.716666666666667,575,643,2018-12-23T23:52:00.000,120,332,123,68
303,2018-12-25,8.466666666666667,465,508,2018-12-25T01:14:00.000,109,232,124,43
304,2018-12-26,8.833333333333334,465,530,2018-12-26T01:36:30.000,87,307,71,65
305,2018-12-27,7.183333333333334,388,431,2018-12-27T00:46:00.000,91,206,91,43
306,2018-12-28,7.166666666666667,392,430,2018-12-28T00:19:00.000,57,256,79,38
307,2018-12-29,8.233333333333333,432,494,2018-12-29T04:33:00.000,75,273,84,62
308,2018-12-30,4.516666666666667,231,271,2018-12-30T05:32:30.000,52,155,24,40
309,2018-12-31,10.583333333333334,564,635,2018-12-31T01:19:00.000,77,328,159,71
310,2019-01-01,7.966666666666667,416,478,2019-01-01T02:04:00.000,63,233,120,62
311,2019-01-02,8.533333333333333,449,512,2019-01-01T23:27:30.000,69,296,84,63
312,2019-01-03,8.216666666666667,432,493,2019-01-02T23:45:00.000,73,289,70,61
313,2019-01-04,8.733333333333333,430,524,2019-01-03T23:36:30.000,73,316,41,94
314,2019-01-05,10.4,548,624,2019-01-04T22:53:30.000,89,366,93,76
315,2019-01-06,9.6,497,576,2019-01-06T00:34:30.000,79,317,101,79
316,2019-01-07,9.433333333333334,509,566,2019-01-06T22:28:00.000,71,314,124,57
317,2019-01-08,8.75,438,525,2019-01-07T23:15:00.000,61,314,63,87
318,2019-01-09,7.866666666666666,400,472,2019-01-08T23:57:30.000,76,252,72,72
319,2019-01-10,7.95,422,477,2019-01-10T00:30:00.000,71,247,104,55
320,2019-01-11,6.916666666666667,356,415,2019-01-11T00:43:30.000,66,206,84,59
321,2019-01-12,6.866666666666666,306,412,2019-01-12T04:49:00.000,98,182,26,106
322,2019-01-13,6.533333333333333,363,392,2019-01-13T04:51:00.000,110,150,103,29
323,2019-01-14,8.816666666666666,474,529,2019-01-13T23:02:30.000,90,274,110,55
324,2019-01-15,8.616666666666667,462,517,2019-01-14T23:15:00.000,101,265,96,55
325,2019-01-16,8.716666666666667,459,523,2019-01-15T23:06:00.000,91,319,49,64
326,2019-01-17,7.65,397,459,2019-01-17T00:10:00.000,99,215,83,62
327,2019-01-18,7.416666666666667,411,445,2019-01-18T00:30:30.000,123,206,82,34
328,2019-01-19,7.683333333333334,406,461,2019-01-19T02:00:00.000,118,196,92,55
329,2019-01-20,8.4,450,504,2019-01-20T01:16:30.000,86,266,98,54
330,2019-01-21,7.766666666666667,418,466,2019-01-21T01:57:30.000,69,258,91,48
331,2019-01-22,8.266666666666667,439,496,2019-01-21T23:11:00.000,85,258,96,57
332,2019-01-23,8.016666666666667,434,481,2019-01-22T23:41:30.000,97,231,106,47
333,2019-01-24,7.916666666666667,436,475,2019-01-23T23:40:30.000,102,230,104,39
334,2019-01-25,8.25,455,495,2019-01-24T23:21:30.000,83,254,118,40
335,2019-01-26,7.683333333333334,418,461,2019-01-26T00:41:00.000,100,215,103,43
336,2019-01-27,8.183333333333334,425,491,2019-01-27T01:11:00.000,74,316,35,66
337,2019-01-28,8.233333333333333,438,494,2019-01-27T23:23:00.000,74,263,101,56
338,2019-01-29,8.266666666666667,431,496,2019-01-28T23:33:00.000,84,214,133,65
339,2019-01-30,8.966666666666667,496,538,2019-01-29T22:54:30.000,97,241,158,42
340,2019-01-31,7.433333333333334,415,446,2019-01-31T00:11:30.000,56,247,112,31
341,2019-02-01,7.8,417,468,2019-01-31T23:54:30.000,86,229,102,51
342,2019-02-02,7.766666666666667,419,466,2019-02-02T02:07:00.000,79,259,81,47
343,2019-02-03,7.866666666666666,422,472,2019-02-03T02:24:00.000,95,214,113,50
344,2019-02-04,7.283333333333333,381,437,2019-02-03T23:54:00.000,84,224,73,56
345,2019-02-05,7.933333333333334,419,476,2019-02-05T00:04:30.000,106,236,77,57
346,2019-02-06,7.3,392,438,2019-02-06T00:09:00.000,95,200,97,46
347,2019-02-07,6.833333333333333,372,410,2019-02-07T00:51:00.000,74,196,102,38
348,2019-02-08,6.383333333333334,344,383,2019-02-08T03:28:30.000,80,155,109,39
349,2019-02-09,9.5,516,570,2019-02-09T00:53:00.000,90,273,153,54
350,2019-02-10,8.716666666666667,471,523,2019-02-10T01:40:00.000,131,230,110,52
351,2019-02-11,7.416666666666667,408,445,2019-02-10T23:49:00.000,64,223,121,37
352,2019-02-12,7.566666666666666,399,454,2019-02-12T00:56:00.000,78,223,98,55
353,2019-02-13,7.883333333333334,422,473,2019-02-12T23:28:30.000,112,234,76,51
354,2019-02-14,8.8,483,528,2019-02-13T22:36:00.000,104,256,123,45
355,2019-02-15,7.2,393,432,2019-02-15T00:23:00.000,72,224,97,39
356,2019-02-16,7.683333333333334,416,461,2019-02-16T03:09:00.000,83,241,92,45
357,2019-02-17,8.033333333333333,420,482,2019-02-17T00:52:00.000,116,202,102,62
358,2019-02-18,7.633333333333334,410,458,2019-02-17T23:38:00.000,67,257,86,48
359,2019-02-19,7.933333333333334,408,476,2019-02-18T23:30:30.000,70,286,52,68
360,2019-02-20,7.75,414,465,2019-02-19T23:43:30.000,93,217,104,51
361,2019-02-21,8.016666666666667,443,481,2019-02-20T23:26:30.000,78,259,106,38
362,2019-02-22,8.066666666666666,428,484,2019-02-21T23:00:00.000,100,224,104,56
363,2019-02-23,7.15,375,429,2019-02-23T01:09:30.000,58,246,71,54
364,2019-02-24,8.383333333333333,453,503,2019-02-23T23:58:30.000,79,269,105,50
365,2019-02-25,7.883333333333334,425,473,2019-02-24T23:17:00.000,68,277,80,48
366,2019-02-26,7.65,404,459,2019-02-25T23:40:00.000,99,225,80,55
367,2019-02-27,8.133333333333333,417,488,2019-02-26T23:04:00.000,101,245,71,71
368,2019-02-28,7.133333333333334,372,428,2019-02-28T00:11:00.000,76,218,78,56
369,2019-03-01,9.383333333333333,508,563,2019-02-28T22:28:00.000,147,212,149,55
370,2019-03-02,8.133333333333333,414,488,2019-03-02T01:12:30.000,88,230,96,74
371,2019-03-03,7.483333333333333,412,449,2019-03-03T02:27:30.000,74,252,86,37
372,2019-03-04,7.916666666666667,435,475,2019-03-03T23:48:30.000,93,254,88,40
373,2019-03-05,8.333333333333334,461,500,2019-03-04T23:19:00.000,87,300,74,39
374,2019-03-06,7.716666666666667,428,463,2019-03-06T00:04:30.000,66,270,92,35
375,2019-03-07,7.483333333333333,404,449,2019-03-06T23:54:00.000,113,191,100,45
376,2019-03-08,8.1,435,486,2019-03-07T23:03:00.000,97,264,74,51
377,2019-03-09,7.816666666666666,415,469,2019-03-09T00:33:30.000,73,266,76,54
378,2019-03-10,8.183333333333334,401,491,2019-03-10T00:11:00.000,80,214,107,30
379,2019-03-11,7.366666666666666,409,442,2019-03-10T23:55:30.000,94,206,109,33
380,2019-03-12,7.966666666666667,426,478,2019-03-12T00:11:00.000,112,193,121,52
381,2019-03-13,6.766666666666667,373,406,2019-03-12T23:34:00.000,66,223,84,33
382,2019-03-14,8.8,461,528,2019-03-13T22:52:00.000,93,286,82,67
383,2019-03-15,6.433333333333334,344,386,2019-03-14T23:47:30.000,92,203,49,42
384,2019-03-16,8.566666666666666,464,514,2019-03-15T23:13:00.000,101,262,101,50
385,2019-03-17,7.783333333333333,412,467,2019-03-17T05:20:00.000,60,303,49,55
386,2019-03-18,7.433333333333334,410,446,2019-03-17T23:57:30.000,52,244,114,36
387,2019-03-19,7.583333333333333,413,455,2019-03-18T23:56:00.000,88,219,106,42
388,2019-03-20,7.333333333333333,393,440,2019-03-19T23:01:00.000,49,247,97,47
389,2019-03-21,7.85,421,471,2019-03-20T23:32:00.000,102,202,117,50
390,2019-03-22,6.683333333333334,369,401,2019-03-21T23:37:00.000,92,183,94,32
391,2019-03-23,8.05,412,483,2019-03-23T00:07:30.000,75,262,75,71
392,2019-03-24,4.45,233,267,2019-03-24T05:36:00.000,44,132,57,34
393,2019-03-25,7.616666666666666,406,457,2019-03-24T23:38:00.000,72,251,83,51
394,2019-03-26,7.466666666666667,404,448,2019-03-25T23:10:00.000,77,217,110,44
395,2019-03-27,7.683333333333334,417,461,2019-03-26T22:40:00.000,114,218,85,44
396,2019-03-28,8.25,446,495,2019-03-27T22:50:00.000,96,228,122,49
397,2019-03-29,6.716666666666667,373,403,2019-03-29T00:20:00.000,54,199,120,30
398,2019-03-30,6.35,318,381,2019-03-30T04:17:30.000,99,189,30,63
399,2019-03-31,11.383333333333333,571,683,2019-03-30T22:58:30.000,99,386,86,112
400,2019-04-01,7.816666666666666,420,469,2019-03-31T23:13:00.000,65,287,68,49
401,2019-04-02,7.85,420,471,2019-04-01T23:17:30.000,109,254,57,51
402,2019-04-03,7.2,393,432,2019-04-02T22:52:00.000,97,220,76,39
403,2019-04-04,8.416666666666666,446,505,2019-04-03T22:33:00.000,79,274,93,59
404,2019-04-05,7.7,430,462,2019-04-04T22:32:00.000,78,283,69,32
405,2019-04-06,5.566666666666666,281,334,2019-04-06T03:16:30.000,61,185,35,53
406,2019-04-07,8.083333333333334,422,485,2019-04-07T02:46:30.000,70,230,122,63
407,2019-04-08,8.016666666666667,431,481,2019-04-07T23:13:30.000,78,287,66,50
408,2019-04-09,7.583333333333333,428,455,2019-04-08T23:42:00.000,67,242,119,27
409,2019-04-10,7.45,407,447,2019-04-09T23:06:30.000,81,222,104,40
410,2019-04-11,7.883333333333334,422,473,2019-04-10T23:14:30.000,96,206,120,51
411,2019-04-12,7.383333333333334,394,443,2019-04-11T23:36:00.000,92,193,109,49
412,2019-04-13,8.766666666666667,474,526,2019-04-13T01:44:00.000,106,243,125,52
413,2019-04-14,7.55,369,453,2019-04-14T04:51:00.000,64,272,33,84
414,2019-04-15,7.666666666666667,416,460,2019-04-14T23:34:00.000,94,216,106,44
415,2019-04-16,7.566666666666666,400,454,2019-04-15T23:39:30.000,58,296,46,54
416,2019-04-17,7.983333333333333,414,479,2019-04-16T23:14:30.000,92,268,54,65
417,2019-04-18,8.35,454,501,2019-04-17T23:55:00.000,93,215,146,47
418,2019-04-19,8.666666666666666,446,520,2019-04-18T23:54:00.000,101,233,112,74
419,2019-04-20,5.716666666666667,307,343,2019-04-20T02:24:00.000,81,198,28,36
420,2019-04-21,9.0,487,540,2019-04-21T02:27:00.000,77,275,135,53
421,2019-04-23,8.283333333333333,428,497,2019-04-22T23:22:00.000,59,320,49,69
422,2019-04-24,7.716666666666667,431,463,2019-04-23T23:54:30.000,78,242,111,32
423,2019-04-25,8.983333333333333,459,539,2019-04-24T22:42:30.000,72,305,82,80
424,2019-04-26,7.216666666666667,391,433,2019-04-26T00:15:00.000,81,217,93,42
425,2019-04-27,8.916666666666666,483,535,2019-04-27T01:02:30.000,95,252,136,52
426,2019-04-28,8.316666666666666,448,499,2019-04-28T04:49:30.000,121,252,75,51
427,2019-04-29,8.033333333333333,440,482,2019-04-28T23:18:30.000,71,233,136,42
428,2019-04-30,8.266666666666667,434,496,2019-04-30T00:45:00.000,81,241,112,62
429,2019-05-01,6.35,359,381,2019-05-01T01:39:00.000,103,153,103,22
430,2019-05-02,7.916666666666667,409,475,2019-05-02T00:23:00.000,86,254,69,66
431,2019-05-03,9.016666666666667,482,541,2019-05-02T23:35:00.000,87,319,76,59
432,2019-05-04,6.25,349,375,2019-05-04T03:06:00.000,74,189,86,26
433,2019-05-05,6.35,330,381,2019-05-05T04:53:00.000,56,197,77,51
434,2019-05-08,8.183333333333334,439,491,2019-05-07T23:26:00.000,101,223,115,52
435,2019-05-09,8.116666666666667,458,487,2019-05-08T23:32:30.000,99,238,121,29
436,2019-05-10,7.683333333333334,420,461,2019-05-09T23:58:30.000,87,243,90,41
437,2019-05-11,8.65,459,519,2019-05-11T00:17:00.000,107,215,137,60
438,2019-05-12,8.483333333333333,444,509,2019-05-12T02:10:30.000,89,304,51,65
439,2019-05-13,7.1,377,426,2019-05-13T00:31:00.000,67,215,95,49
440,2019-05-14,7.9,437,474,2019-05-13T23:47:30.000,84,238,115,37
441,2019-05-15,8.383333333333333,453,503,2019-05-14T23:16:00.000,100,231,122,50
442,2019-05-16,8.766666666666667,475,526,2019-05-16T00:01:30.000,81,281,113,51
443,2019-05-17,9.033333333333333,480,542,2019-05-16T22:56:00.000,62,334,84,62
444,2019-05-18,4.516666666666667,231,271,2019-05-18T05:37:00.000,39,169,23,40
445,2019-05-19,8.566666666666666,466,514,2019-05-19T02:13:00.000,129,202,135,48
446,2019-05-20,7.816666666666666,416,469,2019-05-19T23:53:00.000,42,256,118,53
447,2019-05-21,8.283333333333333,443,497,2019-05-20T23:37:00.000,73,281,89,54
448,2019-05-22,7.516666666666667,384,451,2019-05-22T00:08:30.000,89,192,103,67
449,2019-05-23,7.866666666666666,417,472,2019-05-22T23:58:00.000,80,261,76,55
450,2019-05-24,9.133333333333333,489,548,2019-05-23T23:58:00.000,125,256,108,59
451,2019-05-25,6.75,362,405,2019-05-25T02:03:00.000,79,196,87,43
452,2019-05-26,6.516666666666667,339,391,2019-05-26T00:46:00.000,89,145,105,52
453,2019-05-27,7.316666666666666,389,439,2019-05-27T03:32:30.000,66,227,96,50
454,2019-05-28,7.783333333333333,411,467,2019-05-27T23:41:30.000,72,246,93,56
455,2019-05-29,7.6,405,456,2019-05-29T00:06:30.000,82,266,57,51
456,2019-05-30,7.9,438,474,2019-05-29T23:24:00.000,92,224,122,36
457,2019-05-31,7.983333333333333,443,479,2019-05-30T23:45:30.000,76,248,119,36
458,2019-06-01,6.55,340,393,2019-06-01T04:37:00.000,99,191,50,53
459,2019-06-02,10.816666666666666,581,649,2019-06-01T23:53:30.000,104,329,148,68
460,2019-06-03,7.316666666666666,366,439,2019-06-03T00:18:00.000,50,251,65,73
461,2019-06-04,8.116666666666667,432,487,2019-06-03T23:37:00.000,106,218,108,55
462,2019-06-05,7.966666666666667,426,478,2019-06-04T23:40:00.000,85,241,100,52
463,2019-06-06,9.15,476,549,2019-06-05T23:47:00.000,95,305,76,73
464,2019-06-07,8.016666666666667,446,481,2019-06-07T00:13:00.000,91,250,105,35
465,2019-06-08,9.016666666666667,458,541,2019-06-07T23:09:00.000,60,308,90,83
466,2019-06-09,7.4,385,444,2019-06-09T03:35:00.000,102,235,48,59
467,2019-06-10,7.35,389,441,2019-06-10T00:14:30.000,84,219,86,52
468,2019-06-11,7.85,415,471,2019-06-11T00:02:00.000,67,266,82,56
469,2019-06-12,7.783333333333333,416,467,2019-06-12T00:19:30.000,104,208,104,51
470,2019-06-13,7.383333333333334,392,443,2019-06-13T00:27:00.000,69,232,91,51
471,2019-06-14,7.666666666666667,414,460,2019-06-14T00:12:30.000,78,241,95,46
472,2019-06-15,7.6,387,456,2019-06-15T01:53:00.000,62,258,67,69
473,2019-06-16,4.566666666666666,239,274,2019-06-16T05:28:30.000,48,162,29,35
474,2019-06-18,8.916666666666666,466,535,2019-06-17T22:46:30.000,81,297,88,69
475,2019-06-19,7.566666666666666,404,454,2019-06-19T00:25:30.000,73,235,96,50
476,2019-06-20,7.966666666666667,422,478,2019-06-19T23:58:00.000,76,246,100,56
477,2019-06-21,7.3,384,438,2019-06-21T00:33:30.000,61,241,82,54
478,2019-06-22,8.75,452,525,2019-06-22T01:32:00.000,89,279,84,73
479,2019-06-23,9.55,481,573,2019-06-23T00:28:30.000,87,297,97,92
480,2019-06-24,7.466666666666667,405,448,2019-06-24T00:11:30.000,101,208,96,43
481,2019-06-25,7.75,417,465,2019-06-25T00:02:30.000,109,208,100,48
482,2019-06-26,7.633333333333334,400,458,2019-06-26T00:28:00.000,82,252,66,58
483,2019-06-27,7.45,396,447,2019-06-27T00:38:30.000,103,218,75,51
484,2019-06-28,9.0,473,540,2019-06-28T00:24:00.000,120,243,110,67
485,2019-06-29,10.183333333333334,528,611,2019-06-29T03:02:30.000,80,367,81,83
486,2019-06-30,6.733333333333333,335,404,2019-06-30T03:38:30.000,97,165,73,69
487,2019-07-01,7.45,417,447,2019-07-01T00:12:00.000,58,289,70,30
488,2019-07-02,7.5,397,450,2019-07-02T00:35:00.000,88,222,87,53
489,2019-07-03,9.383333333333333,450,563,2019-07-02T22:21:30.000,87,260,103,113
490,2019-07-04,7.1,367,426,2019-07-04T02:51:30.000,97,189,81,59
491,2019-07-05,9.15,482,549,2019-07-05T03:19:30.000,81,286,115,67
492,2019-07-06,8.866666666666667,468,532,2019-07-06T01:22:00.000,85,304,79,64
493,2019-07-07,8.4,440,504,2019-07-07T05:09:30.000,108,254,78,64
494,2019-07-08,8.15,425,489,2019-07-07T23:40:00.000,51,309,65,64
495,2019-07-09,8.25,448,495,2019-07-08T23:50:00.000,96,234,118,47
496,2019-07-10,9.1,475,546,2019-07-09T23:58:00.000,83,302,90,71
497,2019-07-11,10.316666666666666,550,619,2019-07-10T23:28:30.000,124,320,106,69
498,2019-07-12,7.8,425,468,2019-07-12T03:13:00.000,96,230,99,43
499,2019-07-13,6.4,317,384,2019-07-13T05:35:00.000,86,173,58,67
500,2019-07-14,8.133333333333333,439,488,2019-07-14T02:25:00.000,58,292,89,49
501,2019-07-15,6.65,353,399,2019-07-15T01:51:00.000,84,183,86,46
502,2019-07-16,7.566666666666666,396,454,2019-07-15T23:47:30.000,95,253,48,58
503,2019-07-17,7.75,418,465,2019-07-17T00:21:00.000,87,262,69,47
504,2019-07-18,8.6,458,516,2019-07-18T00:38:30.000,99,258,101,58
505,2019-07-19,8.1,420,486,2019-07-19T00:42:00.000,51,310,59,66
506,2019-07-20,7.366666666666666,392,442,2019-07-20T02:15:00.000,95,207,90,50
507,2019-07-21,7.25,374,435,2019-07-21T03:58:00.000,93,220,61,61
508,2019-07-22,7.983333333333333,424,479,2019-07-22T00:00:00.000,81,260,83,55
509,2019-07-23,6.933333333333334,391,416,2019-07-23T00:27:00.000,92,234,65,25
510,2019-07-24,7.633333333333334,431,458,2019-07-24T00:04:30.000,86,206,139,27
511,2019-07-25,7.45,404,447,2019-07-25T00:35:00.000,70,232,102,43
512,2019-07-26,8.366666666666667,439,502,2019-07-26T01:18:00.000,71,324,44,63
513,2019-07-27,7.25,388,435,2019-07-27T02:17:00.000,64,231,93,47
514,2019-07-29,7.0,373,420,2019-07-29T01:29:00.000,81,219,73,47
515,2019-07-30,7.533333333333333,388,452,2019-07-30T00:16:00.000,82,233,73,64
516,2019-07-31,7.166666666666667,383,430,2019-07-31T00:26:30.000,68,218,97,47
517,2019-08-01,9.366666666666667,516,562,2019-08-01T00:56:00.000,127,228,161,46
518,2019-08-02,7.133333333333334,389,428,2019-08-02T00:29:00.000,86,198,105,39
519,2019-08-03,10.216666666666667,510,613,2019-08-03T00:57:00.000,109,317,84,103
520,2019-08-04,3.933333333333333,194,236,2019-08-04T08:16:00.000,19,154,21,42
521,2019-08-05,7.916666666666667,429,475,2019-08-04T23:58:00.000,92,239,98,46
522,2019-08-06,9.083333333333334,464,545,2019-08-06T00:19:00.000,85,293,86,81
523,2019-08-07,8.366666666666667,456,502,2019-08-06T23:51:00.000,73,278,105,46
524,2019-08-08,8.283333333333333,442,497,2019-08-08T01:43:00.000,59,288,95,55
525,2019-08-09,10.55,513,633,2019-08-08T23:17:00.000,77,323,113,120
526,2019-08-10,6.866666666666666,374,412,2019-08-10T02:09:00.000,81,191,102,38
527,2019-08-11,4.733333333333333,243,284,2019-08-11T06:02:30.000,41,197,5,41
528,2019-08-12,7.066666666666666,381,424,2019-08-11T23:57:00.000,84,204,93,43
529,2019-08-13,7.55,391,453,2019-08-13T00:26:00.000,60,238,93,62
530,2019-08-14,7.966666666666667,412,478,2019-08-13T23:56:00.000,84,275,53,66
531,2019-08-15,8.216666666666667,445,493,2019-08-14T23:47:00.000,97,224,124,48
532,2019-08-16,8.466666666666667,446,508,2019-08-15T23:33:30.000,127,243,76,62
533,2019-08-17,7.9,411,474,2019-08-17T02:12:00.000,87,254,70,63
534,2019-08-18,6.9,364,414,2019-08-18T03:09:30.000,78,194,92,50
535,2019-08-19,7.516666666666667,386,451,2019-08-19T00:31:30.000,107,211,68,65
536,2019-08-20,8.933333333333334,473,536,2019-08-19T23:29:00.000,49,356,68,63
537,2019-08-21,5.833333333333333,318,350,2019-08-20T23:51:00.000,74,176,68,32
538,2019-08-22,9.45,483,567,2019-08-21T22:35:00.000,93,301,89,84
539,2019-08-23,7.433333333333334,401,446,2019-08-22T23:50:30.000,93,195,113,45
540,2019-08-24,9.7,528,582,2019-08-23T23:27:30.000,112,286,130,54
541,2019-08-25,8.35,415,501,2019-08-25T00:29:00.000,68,179,168,86
542,2019-08-26,8.383333333333333,452,503,2019-08-26T00:42:30.000,109,236,107,51
543,2019-08-27,7.7,420,462,2019-08-27T01:00:30.000,48,287,85,42
544,2019-08-28,8.133333333333333,408,488,2019-08-28T01:46:30.000,50,248,110,80
545,2019-08-29,6.5,357,390,2019-08-29T00:50:30.000,78,172,107,33
546,2019-08-30,9.333333333333334,494,560,2019-08-30T00:48:30.000,94,287,113,66
547,2019-08-31,9.016666666666667,471,541,2019-08-31T02:20:00.000,98,284,89,70
548,2019-09-02,8.6,457,516,2019-09-02T02:31:00.000,91,274,92,59
549,2019-09-03,6.433333333333334,318,386,2019-09-03T01:08:30.000,65,211,42,68
550,2019-09-04,8.383333333333333,463,503,2019-09-04T00:19:00.000,80,282,101,40
551,2019-09-05,8.466666666666667,459,508,2019-09-04T23:45:30.000,75,272,112,49
552,2019-09-06,7.666666666666667,405,460,2019-09-05T23:43:30.000,69,299,37,55
553,2019-09-08,7.316666666666666,369,439,2019-09-08T02:21:30.000,49,303,17,70
554,2019-09-09,8.866666666666667,435,532,2019-09-09T00:59:30.000,78,282,75,97
555,2019-09-10,8.083333333333334,423,485,2019-09-10T01:23:30.000,56,317,50,62
556,2019-09-11,7.566666666666666,429,454,2019-09-11T00:28:30.000,63,262,104,25
557,2019-09-12,6.483333333333333,338,389,2019-09-12T00:15:00.000,73,215,50,51
558,2019-09-14,7.616666666666666,416,457,2019-09-14T01:09:00.000,62,273,81,41
559,2019-09-15,8.9,476,534,2019-09-15T00:33:30.000,89,279,108,58
560,2019-09-16,5.816666666666666,318,349,2019-09-16T01:39:00.000,51,203,64,31
561,2019-09-17,7.4,393,444,2019-09-16T23:47:00.000,99,226,68,51
562,2019-09-18,8.066666666666666,438,484,2019-09-17T23:42:00.000,54,268,116,46
563,2019-09-19,8.016666666666667,434,481,2019-09-18T23:31:00.000,60,284,90,47
564,2019-09-20,7.533333333333333,404,452,2019-09-19T23:45:00.000,88,233,83,48
565,2019-09-21,7.433333333333334,353,446,2019-09-21T04:31:00.000,50,241,62,93
566,2019-09-22,4.966666666666667,265,298,2019-09-22T05:39:00.000,31,224,10,33
567,2019-09-23,7.0,375,420,2019-09-23T00:17:00.000,65,217,93,45
568,2019-09-24,7.266666666666667,380,436,2019-09-24T01:03:30.000,52,238,90,56
569,2019-09-25,8.2,447,492,2019-09-24T23:53:30.000,68,267,112,45
570,2019-09-26,7.733333333333333,385,464,2019-09-26T00:54:00.000,41,293,51,79
571,2019-09-27,6.916666666666667,381,415,2019-09-27T00:25:30.000,49,269,63,34
572,2019-09-28,5.083333333333333,254,305,2019-09-28T05:26:30.000,43,158,53,51
573,2019-09-29,5.75,312,345,2019-09-29T02:46:30.000,50,169,93,33
574,2019-09-30,7.166666666666667,401,430,2019-09-30T00:28:30.000,56,227,118,29
575,2019-10-01,7.583333333333333,414,455,2019-09-30T23:56:00.000,92,246,76,41
576,2019-10-02,7.783333333333333,399,467,2019-10-01T23:42:30.000,82,225,92,68
577,2019-10-03,7.683333333333334,403,461,2019-10-02T23:50:30.000,88,202,113,58
578,2019-10-04,6.166666666666667,334,370,2019-10-03T23:39:00.000,84,181,69,36
579,2019-10-05,6.95,371,417,2019-10-05T01:10:00.000,78,207,86,46
580,2019-10-06,8.85,457,531,2019-10-06T00:48:30.000,76,280,101,74
581,2019-10-07,8.35,431,501,2019-10-07T00:43:00.000,39,312,80,70
582,2019-10-09,7.9,422,474,2019-10-08T23:49:00.000,93,232,97,52
583,2019-10-10,7.6,410,456,2019-10-09T23:53:00.000,86,244,80,46
584,2019-10-11,6.883333333333334,378,413,2019-10-11T00:20:00.000,65,220,93,35
585,2019-10-12,8.05,403,483,2019-10-12T01:47:00.000,71,261,71,80
586,2019-10-14,6.983333333333333,373,419,2019-10-14T01:23:00.000,73,207,93,46
587,2019-10-15,7.75,427,465,2019-10-14T23:55:00.000,77,227,123,38
588,2019-10-16,7.783333333333333,419,467,2019-10-15T23:49:30.000,92,229,98,48
589,2019-10-17,7.816666666666666,409,469,2019-10-17T00:00:00.000,67,247,95,60
590,2019-10-18,8.45,461,507,2019-10-17T23:15:00.000,63,271,127,46
591,2019-10-19,7.566666666666666,411,454,2019-10-19T01:32:00.000,92,225,94,43
592,2019-10-20,6.733333333333333,358,404,2019-10-20T01:57:00.000,94,182,82,46
593,2019-10-21,8.416666666666666,444,505,2019-10-20T23:34:00.000,91,231,122,61
594,2019-10-23,4.75,252,285,2019-10-23T02:53:00.000,50,128,74,33
595,2019-10-24,8.766666666666667,466,526,2019-10-23T22:59:30.000,79,272,115,60
596,2019-10-25,7.583333333333333,422,455,2019-10-25T00:08:00.000,102,175,145,33
597,2019-10-26,6.55,350,393,2019-10-26T04:46:00.000,82,195,73,43
598,2019-10-27,8.216666666666667,408,493,2019-10-26T23:58:00.000,60,236,112,85
599,2019-10-28,7.316666666666666,397,439,2019-10-28T00:28:00.000,97,184,116,42
600,2019-10-29,7.5,394,450,2019-10-29T01:06:00.000,112,182,100,56
601,2019-10-31,8.366666666666667,434,502,2019-10-31T00:06:00.000,84,283,67,68
602,2019-11-01,7.6,412,456,2019-11-01T00:33:00.000,90,243,79,44
603,2019-11-02,6.133333333333334,333,368,2019-11-02T02:52:30.000,79,190,64,35
604,2019-11-03,3.933333333333333,207,236,2019-11-03T04:27:30.000,40,117,50,29
605,2019-11-04,7.633333333333334,412,458,2019-11-04T00:11:00.000,113,204,95,46
606,2019-11-05,8.866666666666667,442,532,2019-11-05T00:41:30.000,76,277,89,90
607,2019-11-06,7.233333333333333,393,434,2019-11-06T00:51:00.000,79,199,115,41
608,2019-11-07,7.85,439,471,2019-11-07T00:05:00.000,111,211,117,32
609,2019-11-08,7.55,408,453,2019-11-08T00:10:00.000,85,231,92,45
610,2019-11-09,7.666666666666667,415,460,2019-11-09T00:29:30.000,84,225,106,45
611,2019-11-10,5.95,280,357,2019-11-09T22:30:30.000,71,145,64,77
612,2019-11-11,8.283333333333333,449,497,2019-11-10T23:17:00.000,121,219,109,48
613,2019-11-12,7.833333333333333,416,470,2019-11-11T23:57:00.000,106,210,100,54
614,2019-11-13,8.083333333333334,441,485,2019-11-12T23:32:00.000,88,257,96,44
615,2019-11-14,3.1333333333333333,165,188,2019-11-13T23:49:00.000,33,98,34,23
616,2019-11-16,7.5,369,450,2019-11-16T02:26:00.000,51,231,87,81
617,2019-11-18,6.316666666666666,353,379,2019-11-18T01:07:30.000,77,185,91,26
618,2019-11-19,8.233333333333333,451,494,2019-11-18T23:35:00.000,114,222,115,43
619,2019-11-20,7.7,416,462,2019-11-19T23:59:00.000,88,234,94,46
620,2019-11-21,8.183333333333334,441,491,2019-11-20T23:53:30.000,101,184,156,50
621,2019-11-23,6.216666666666667,332,373,2019-11-23T02:47:00.000,82,184,66,41
622,2019-11-25,5.85,311,351,2019-11-25T02:26:00.000,60,146,105,40
623,2019-11-26,7.233333333333333,400,434,2019-11-26T01:12:00.000,65,218,117,34
624,2019-11-27,7.35,378,441,2019-11-27T00:15:30.000,64,223,91,63
625,2019-12-01,8.55,456,513,2019-11-30T22:50:00.000,91,241,124,57
626,2019-12-02,6.466666666666667,345,388,2019-12-02T01:11:00.000,100,173,72,43
627,2019-12-03,5.816666666666666,305,349,2019-12-03T02:58:00.000,70,202,33,44
628,2019-12-04,9.316666666666666,463,559,2019-12-03T23:22:30.000,71,290,102,96
629,2019-12-05,3.533333333333333,191,212,2019-12-05T01:54:00.000,50,107,34,21
630,2019-12-06,7.35,378,441,2019-12-06T00:38:00.000,80,244,54,63
631,2019-12-07,7.3,407,438,2019-12-07T01:28:00.000,104,200,103,31
632,2019-12-08,6.25,338,375,2019-12-08T01:11:00.000,88,185,65,37
633,2019-12-09,7.733333333333333,414,464,2019-12-09T01:43:00.000,75,243,96,50
634,2019-12-10,6.883333333333334,354,413,2019-12-10T02:04:00.000,86,210,58,59
635,2019-12-11,6.583333333333333,370,395,2019-12-11T01:13:30.000,37,255,78,25
636,2019-12-14,7.166666666666667,379,430,2019-12-14T02:53:00.000,62,258,59,51
637,2019-12-15,9.9,493,594,2019-12-15T02:25:00.000,62,330,101,101
638,2019-12-16,5.766666666666667,310,346,2019-12-16T03:22:00.000,70,184,56,36
639,2019-12-18,8.133333333333333,443,488,2019-12-18T00:44:00.000,91,276,76,45
640,2019-12-20,7.5,398,450,2019-12-20T01:05:30.000,64,274,60,52
641,2019-12-21,7.466666666666667,368,448,2019-12-21T02:06:30.000,103,207,58,80
642,2019-12-23,7.566666666666666,401,454,2019-12-23T03:01:30.000,84,234,83,53
643,2019-12-24,6.45,331,387,2019-12-24T03:06:00.000,53,213,65,56
644,2019-12-26,7.35,392,441,2019-12-26T02:45:30.000,74,234,84,49
645,2019-12-27,6.55,356,393,2019-12-27T03:01:00.000,69,189,98,37
646,2019-12-28,6.916666666666667,354,415,2019-12-28T03:54:30.000,82,205,67,61
647,2019-12-29,7.35,383,441,2019-12-29T03:05:30.000,73,253,57,58
648,2019-12-31,7.25,387,435,2019-12-31T00:34:30.000,66,231,90,48
649,2020-01-01,7.0,369,420,2020-01-01T00:59:00.000,88,208,73,51
650,2020-01-02,6.416666666666667,351,385,2020-01-02T04:52:00.000,78,187,86,34
651,2020-01-03,11.6,627,696,2020-01-03T00:37:00.000,125,371,131,69
652,2020-01-04,6.933333333333334,371,416,2020-01-04T03:06:30.000,60,232,79,45
653,2020-01-05,6.216666666666667,336,373,2020-01-05T02:15:00.000,45,225,66,37
654,2020-01-06,11.366666666666667,590,682,2020-01-05T22:43:30.000,131,349,110,92
655,2020-01-07,9.666666666666666,511,580,2020-01-07T03:35:30.000,116,327,68,69
656,2020-01-08,7.466666666666667,359,448,2020-01-08T03:58:00.000,51,220,88,89
657,2020-01-09,8.266666666666667,463,496,2020-01-09T07:21:00.000,127,233,103,33
658,2020-01-11,8.583333333333334,457,515,2020-01-11T03:17:00.000,65,300,92,58
659,2020-01-13,8.8,470,528,2020-01-13T01:49:00.000,104,245,121,58
660,2020-01-14,9.35,468,561,2020-01-13T23:40:00.000,59,269,140,93
661,2020-01-15,7.566666666666666,405,454,2020-01-15T02:05:30.000,57,247,101,49
662,2020-01-16,5.35,261,321,2020-01-16T06:49:30.000,65,114,82,60
663,2020-01-17,8.0,430,480,2020-01-17T00:30:00.000,43,312,75,50
664,2020-01-18,6.616666666666666,339,397,2020-01-18T02:58:00.000,59,253,27,58
665,2020-01-19,7.366666666666666,401,442,2020-01-19T03:03:30.000,85,216,100,41
666,2020-01-20,7.883333333333334,418,473,2020-01-20T01:51:00.000,67,282,69,55
667,2020-01-21,8.616666666666667,469,517,2020-01-20T23:22:30.000,65,319,85,48
668,2020-01-22,8.766666666666667,481,526,2020-01-21T23:27:00.000,98,310,73,45
669,2020-01-23,8.116666666666667,451,487,2020-01-23T00:08:00.000,62,303,86,36
670,2020-01-24,8.633333333333333,475,518,2020-01-23T23:42:00.000,62,305,108,43
671,2020-01-25,6.916666666666667,377,415,2020-01-25T02:49:00.000,62,202,113,38
672,2020-01-26,7.733333333333333,415,464,2020-01-26T01:21:30.000,98,227,90,49
673,2020-01-27,7.666666666666667,426,460,2020-01-27T00:14:00.000,80,244,102,34
674,2020-01-28,7.8,417,468,2020-01-28T00:24:30.000,88,252,77,51
675,2020-01-29,7.183333333333334,387,431,2020-01-29T02:33:00.000,61,244,82,44
676,2020-01-30,8.1,435,486,2020-01-30T01:05:30.000,93,242,100,51
677,2020-01-31,8.216666666666667,446,493,2020-01-31T00:34:30.000,101,240,105,47
678,2020-02-01,8.4,437,504,2020-02-01T03:21:30.000,83,287,67,67
679,2020-02-02,7.516666666666667,411,451,2020-02-02T03:21:30.000,99,221,91,40
680,2020-02-03,8.383333333333333,451,503,2020-02-03T00:55:00.000,90,291,70,52
681,2020-02-04,8.3,448,498,2020-02-04T00:40:00.000,87,277,84,50
682,2020-02-05,8.016666666666667,422,481,2020-02-05T01:25:00.000,74,256,92,59
683,2020-02-06,7.833333333333333,416,470,2020-02-06T01:17:30.000,86,245,85,54
684,2020-02-07,7.016666666666667,385,421,2020-02-07T01:10:30.000,97,195,93,36
685,2020-02-08,7.116666666666666,385,427,2020-02-08T02:50:00.000,69,211,105,42
686,2020-02-09,8.7,482,522,2020-02-09T01:39:30.000,91,246,145,40
687,2020-02-10,7.3,409,438,2020-02-10T02:09:30.000,91,201,117,29
688,2020-02-11,8.65,466,519,2020-02-10T23:57:30.000,103,236,127,53
689,2020-02-12,8.133333333333333,448,488,2020-02-12T01:40:30.000,95,230,123,40
690,2020-02-13,7.1,386,426,2020-02-13T01:06:30.000,84,205,97,40
691,2020-02-14,7.966666666666667,433,478,2020-02-14T01:40:00.000,72,238,123,45
692,2020-02-15,6.95,360,417,2020-02-15T03:34:30.000,81,199,80,57
693,2020-02-16,8.283333333333333,430,497,2020-02-16T02:14:00.000,112,202,116,67
694,2020-02-17,8.766666666666667,488,526,2020-02-16T23:42:00.000,94,264,130,38
695,2020-02-18,8.0,426,480,2020-02-18T00:34:00.000,114,230,82,54
696,2020-02-19,8.583333333333334,463,515,2020-02-19T00:02:30.000,91,266,106,52
697,2020-02-20,8.5,432,510,2020-02-20T00:10:30.000,67,256,109,78
698,2020-02-21,8.516666666666667,471,511,2020-02-21T00:00:30.000,137,207,127,40
699,2020-02-22,5.45,274,327,2020-02-22T04:01:00.000,91,163,20,53
700,2020-02-23,7.85,425,471,2020-02-23T02:19:00.000,87,241,97,46
701,2020-02-24,7.7,408,462,2020-02-24T00:57:00.000,77,233,98,54
702,2020-02-25,7.65,404,459,2020-02-25T00:33:00.000,91,227,86,55
703,2020-02-26,10.4,509,624,2020-02-25T22:31:00.000,80,311,118,115
704,2020-02-27,8.55,453,513,2020-02-26T23:36:00.000,100,261,92,60
705,2020-02-28,6.966666666666667,380,418,2020-02-28T01:23:30.000,95,195,90,38
706,2020-02-29,9.566666666666666,507,574,2020-02-29T00:44:00.000,109,298,100,67
707,2020-03-01,7.283333333333333,388,437,2020-03-01T01:43:30.000,81,205,102,49
708,2020-03-02,7.833333333333333,426,470,2020-03-02T00:48:00.000,110,227,89,44
709,2020-03-03,7.783333333333333,405,467,2020-03-03T00:40:00.000,85,290,30,62
710,2020-03-04,7.816666666666666,424,469,2020-03-04T00:36:00.000,105,251,68,45
711,2020-03-05,9.216666666666667,460,553,2020-03-04T23:22:00.000,79,299,82,93
712,2020-03-06,8.1,427,486,2020-03-06T01:02:30.000,82,257,88,59
713,2020-03-07,5.783333333333333,308,347,2020-03-07T03:46:00.000,70,187,51,39
714,2020-03-08,6.666666666666667,353,400,2020-03-08T03:28:00.000,59,220,74,47
715,2020-03-09,7.633333333333334,415,458,2020-03-09T01:41:00.000,110,223,82,43
716,2020-03-10,5.8,314,348,2020-03-10T01:40:00.000,81,186,47,34
717,2020-03-11,7.883333333333334,395,473,2020-03-11T01:31:30.000,101,241,53,78
718,2020-03-12,7.516666666666667,397,451,2020-03-12T01:54:00.000,85,229,83,54
719,2020-03-13,6.25,347,375,2020-03-13T01:14:00.000,109,156,82,28
720,2020-03-18,7.733333333333333,417,464,2020-03-18T00:59:00.000,80,230,107,47
721,2020-03-19,8.1,435,486,2020-03-19T00:44:00.000,96,238,101,51
722,2020-03-20,8.55,446,513,2020-03-20T01:08:00.000,95,246,105,67
723,2020-03-21,7.033333333333333,382,422,2020-03-21T02:05:00.000,81,212,89,40
724,2020-03-22,8.166666666666666,440,490,2020-03-22T02:08:00.000,107,254,79,50
725,2020-03-23,8.266666666666667,414,496,2020-03-23T00:29:30.000,92,250,72,82
726,2020-03-26,7.633333333333334,397,458,2020-03-26T00:31:30.000,84,229,84,61
727,2020-03-27,8.283333333333333,394,497,2020-03-27T00:41:00.000,60,226,108,103
728,2020-03-28,12.783333333333333,632,767,2020-03-27T21:21:00.000,85,408,139,135
729,2020-03-29,8.85,468,531,2020-03-29T02:08:00.000,96,300,72,63
730,2020-03-30,8.85,451,531,2020-03-30T00:19:00.000,75,290,86,80
731,2020-03-31,8.866666666666667,491,532,2020-03-30T23:59:00.000,84,283,124,41
732,2020-04-01,8.033333333333333,416,482,2020-04-01T00:59:00.000,99,224,93,66
733,2020-04-02,7.616666666666666,413,457,2020-04-02T00:58:00.000,86,232,95,44
734,2020-04-04,8.1,453,486,2020-04-04T02:20:00.000,87,214,152,33
735,2020-04-05,8.3,453,498,2020-04-05T01:24:00.000,82,252,119,45
736,2020-04-06,9.0,471,540,2020-04-06T00:22:00.000,107,250,114,69
737,2020-04-08,9.316666666666666,508,559,2020-04-08T00:55:30.000,83,301,124,51
738,2020-04-09,7.2,390,432,2020-04-09T01:13:30.000,66,213,111,42
739,2020-04-10,8.3,443,498,2020-04-10T00:48:00.000,102,258,83,55
740,2020-04-11,7.316666666666666,395,439,2020-04-11T02:52:00.000,66,260,69,44
741,2020-04-12,8.183333333333334,438,491,2020-04-12T02:15:00.000,94,253,91,53
742,2020-04-13,8.2,450,492,2020-04-13T01:18:00.000,81,253,116,42
743,2020-04-14,6.833333333333333,372,410,2020-04-14T01:11:30.000,102,168,102,38
744,2020-04-15,7.45,403,447,2020-04-15T01:36:00.000,89,205,109,44
745,2020-04-17,9.016666666666667,466,541,2020-04-17T01:04:30.000,85,315,66,75
746,2020-04-18,6.916666666666667,362,415,2020-04-18T02:29:00.000,73,230,59,53
747,2020-04-19,8.033333333333333,434,482,2020-04-19T02:27:30.000,71,262,101,48
748,2020-04-20,7.783333333333333,408,467,2020-04-20T01:09:30.000,63,254,91,59
749,2020-04-21,9.033333333333333,475,542,2020-04-21T01:13:00.000,103,279,93,67
750,2020-04-23,8.716666666666667,474,523,2020-04-23T01:29:00.000,92,283,99,49
751,2020-04-24,9.05,478,543,2020-04-24T02:10:00.000,123,254,101,65
752,2020-04-25,7.9,428,474,2020-04-25T02:00:30.000,84,268,76,46
753,2020-04-26,8.566666666666666,464,514,2020-04-26T02:11:30.000,98,256,110,50
754,2020-04-27,8.55,476,513,2020-04-27T01:52:30.000,89,312,75,37
755,2020-04-28,8.25,439,495,2020-04-28T02:21:00.000,94,252,93,56
756,2020-04-29,8.516666666666667,456,511,2020-04-29T01:27:00.000,96,256,104,55
757,2020-04-30,7.783333333333333,434,467,2020-04-30T01:19:00.000,86,234,114,33
758,2020-05-01,8.516666666666667,468,511,2020-05-01T02:27:00.000,93,257,118,43
759,2020-05-02,7.216666666666667,397,433,2020-05-02T02:54:00.000,81,234,82,36
760,2020-05-03,7.933333333333334,426,476,2020-05-03T02:02:30.000,104,210,112,50
761,2020-05-04,8.6,463,516,2020-05-04T02:01:30.000,81,287,95,53
762,2020-05-05,9.016666666666667,492,541,2020-05-05T01:38:00.000,82,306,104,49
763,2020-05-06,8.1,432,486,2020-05-06T01:15:30.000,88,252,92,54
764,2020-05-07,8.133333333333333,445,488,2020-05-07T02:01:00.000,110,223,112,43
765,2020-05-08,9.316666666666666,508,559,2020-05-08T00:58:30.000,96,282,130,51
766,2020-05-09,8.633333333333333,474,518,2020-05-09T01:44:00.000,84,275,115,44
767,2020-05-10,6.483333333333333,338,389,2020-05-10T03:15:00.000,70,183,85,51
768,2020-05-11,8.283333333333333,456,497,2020-05-11T02:04:30.000,77,295,84,41
769,2020-05-12,9.516666666666667,505,571,2020-05-12T00:50:30.000,116,282,107,66
770,2020-05-13,9.316666666666666,500,559,2020-05-13T01:32:00.000,71,343,86,59
771,2020-05-14,8.983333333333333,493,539,2020-05-14T01:18:00.000,108,260,125,46
772,2020-05-15,7.666666666666667,412,460,2020-05-15T01:44:00.000,90,230,92,48
773,2020-05-16,8.133333333333333,435,488,2020-05-16T02:42:00.000,93,234,108,53
774,2020-05-17,7.016666666666667,385,421,2020-05-17T02:37:00.000,68,218,99,36
775,2020-05-18,7.8,426,468,2020-05-18T01:53:30.000,70,297,59,42
776,2020-05-19,7.633333333333334,413,458,2020-05-19T01:34:00.000,78,227,108,45
777,2020-05-20,8.433333333333334,465,506,2020-05-20T01:01:00.000,118,264,83,41
778,2020-05-21,8.483333333333333,448,509,2020-05-21T01:25:30.000,119,214,115,61
779,2020-05-24,7.866666666666666,423,472,2020-05-24T02:28:00.000,76,257,90,49
780,2020-05-25,8.766666666666667,460,526,2020-05-25T01:47:30.000,85,306,69,66
781,2020-05-26,8.15,426,489,2020-05-26T01:31:00.000,71,290,65,63
782,2020-05-27,8.966666666666667,486,538,2020-05-27T00:54:30.000,95,273,118,52
783,2020-05-28,9.683333333333334,521,581,2020-05-28T01:09:00.000,88,360,73,60
784,2020-05-29,9.683333333333334,496,581,2020-05-29T00:53:30.000,78,335,83,85
785,2020-05-30,8.283333333333333,445,497,2020-05-30T02:25:30.000,66,289,90,52
786,2020-05-31,6.95,363,417,2020-05-31T03:10:30.000,77,221,65,54
787,2020-06-01,8.55,462,513,2020-06-01T01:44:00.000,72,280,110,51
788,2020-06-02,9.283333333333333,472,557,2020-06-02T01:31:30.000,79,298,95,85
789,2020-06-03,9.066666666666666,482,544,2020-06-03T01:31:00.000,100,265,117,62
790,2020-06-04,9.333333333333334,482,560,2020-06-04T02:01:00.000,65,384,33,78
791,2020-06-05,9.8,504,588,2020-06-05T01:42:30.000,46,392,66,84
792,2020-06-06,7.866666666666666,389,472,2020-06-06T03:55:00.000,67,258,64,83
793,2020-06-11,8.95,480,537,2020-06-11T01:19:00.000,102,280,98,57
794,2020-06-12,8.066666666666666,426,484,2020-06-12T02:00:00.000,87,292,47,58
795,2020-06-13,8.283333333333333,446,497,2020-06-13T02:09:00.000,97,282,67,51
796,2020-06-14,7.916666666666667,426,475,2020-06-14T02:49:30.000,96,240,90,49
797,2020-06-15,9.183333333333334,492,551,2020-06-15T01:03:00.000,105,300,87,59
798,2020-06-16,8.066666666666666,431,484,2020-06-16T02:11:00.000,81,261,89,53
799,2020-06-17,8.05,421,483,2020-06-17T01:43:00.000,77,237,107,62
800,2020-06-18,8.616666666666667,467,517,2020-06-18T01:35:30.000,76,275,116,50
801,2020-06-19,7.283333333333333,386,437,2020-06-19T02:37:00.000,91,213,82,51
802,2020-06-20,5.833333333333333,304,350,2020-06-20T04:21:00.000,67,147,90,46
803,2020-06-21,8.5,443,510,2020-06-21T02:23:30.000,96,256,91,67
804,2020-06-22,6.55,343,393,2020-06-22T01:23:30.000,62,245,36,50
805,2020-06-24,6.316666666666666,342,379,2020-06-24T01:09:30.000,95,165,82,37
806,2020-06-26,9.35,490,561,2020-06-25T23:05:00.000,66,324,100,71
807,2020-06-27,6.783333333333333,358,407,2020-06-27T02:59:00.000,73,216,69,49
808,2020-06-28,7.85,401,471,2020-06-28T03:57:30.000,75,245,81,70
809,2020-06-29,7.283333333333333,397,437,2020-06-29T01:47:30.000,85,225,87,40
810,2020-06-30,6.85,368,411,2020-06-30T01:39:30.000,77,199,92,43
811,2020-07-01,8.2,441,492,2020-07-01T01:26:00.000,90,251,100,51
812,2020-07-03,7.3,392,438,2020-07-03T00:45:30.000,57,274,61,46
813,2020-07-04,7.233333333333333,368,434,2020-07-04T04:03:00.000,89,234,45,66
814,2020-07-05,7.633333333333334,398,458,2020-07-05T03:19:30.000,59,265,74,60
815,2020-07-06,9.35,515,561,2020-07-06T00:25:00.000,117,251,147,46
816,2020-07-08,8.25,438,495,2020-07-08T01:23:30.000,122,206,110,57
817,2020-07-09,8.466666666666667,447,508,2020-07-09T00:54:00.000,105,242,100,61
818,2020-07-10,6.983333333333333,374,419,2020-07-10T01:40:00.000,72,243,59,45
819,2020-07-11,9.683333333333334,525,581,2020-07-11T04:14:00.000,92,329,104,56
820,2020-07-12,9.883333333333333,505,593,2020-07-11T23:59:30.000,101,277,127,88
821,2020-07-13,8.45,466,507,2020-07-13T01:16:00.000,109,240,117,41
822,2020-07-14,7.5,406,450,2020-07-14T01:08:00.000,105,197,104,44
823,2020-07-15,7.866666666666666,439,472,2020-07-15T01:40:30.000,94,245,100,33
824,2020-07-16,7.283333333333333,410,437,2020-07-16T01:11:30.000,106,188,116,27
825,2020-07-17,9.15,481,549,2020-07-17T00:47:00.000,93,278,110,68
826,2020-07-18,8.116666666666667,432,487,2020-07-18T01:49:00.000,101,254,77,55
827,2020-07-19,8.983333333333333,477,539,2020-07-19T01:12:00.000,100,289,88,62
828,2020-07-20,7.883333333333334,430,473,2020-07-20T01:38:30.000,89,260,81,43
829,2020-07-21,7.083333333333333,370,425,2020-07-21T02:14:30.000,68,222,80,55
830,2020-07-24,7.2,396,432,2020-07-24T01:17:00.000,85,217,94,36
831,2020-07-25,8.916666666666666,473,535,2020-07-25T01:11:00.000,120,255,98,62
832,2020-07-26,9.316666666666666,510,559,2020-07-26T02:47:00.000,126,260,124,49
833,2020-07-27,7.383333333333334,411,443,2020-07-27T00:26:00.000,99,209,103,32
834,2020-07-28,7.616666666666666,424,457,2020-07-28T00:56:00.000,65,279,80,33
835,2020-07-29,8.3,440,498,2020-07-29T02:00:00.000,112,228,100,58
836,2020-07-30,7.616666666666666,365,457,2020-07-30T01:11:00.000,64,240,61,92
837,2020-07-31,8.283333333333333,450,497,2020-07-31T02:15:00.000,114,239,97,47
838,2020-08-01,7.483333333333333,406,449,2020-08-01T02:55:00.000,74,244,88,43
839,2020-08-02,8.666666666666666,462,520,2020-08-02T01:52:00.000,81,303,78,58
840,2020-08-03,8.25,435,495,2020-08-03T01:08:00.000,95,230,110,60
841,2020-08-04,9.15,454,549,2020-08-03T23:24:30.000,80,271,103,95
842,2020-08-05,7.05,370,423,2020-08-05T00:30:00.000,56,243,71,53
843,2020-08-06,6.7,360,402,2020-08-06T01:14:00.000,85,192,83,42
844,2020-08-07,9.6,488,576,2020-08-06T22:54:00.000,72,275,141,88
845,2020-08-08,7.9,407,474,2020-08-08T01:24:00.000,88,240,79,67
846,2020-08-09,9.333333333333334,498,560,2020-08-09T01:01:00.000,97,287,114,62
847,2020-08-10,9.166666666666666,447,550,2020-08-09T22:50:30.000,73,269,105,103
848,2020-08-11,8.016666666666667,435,481,2020-08-11T00:31:30.000,136,212,87,46
849,2020-08-12,7.433333333333334,408,446,2020-08-12T00:49:00.000,92,207,109,38
850,2020-08-13,7.25,394,435,2020-08-13T00:45:00.000,115,198,81,41
851,2020-08-14,7.666666666666667,415,460,2020-08-14T00:34:00.000,107,200,108,45
852,2020-08-15,7.233333333333333,360,434,2020-08-15T01:47:00.000,67,252,41,74
853,2020-08-16,6.916666666666667,359,415,2020-08-16T02:47:00.000,93,192,74,56
854,2020-08-17,10.616666666666667,524,637,2020-08-16T21:40:30.000,108,371,45,113
855,2020-08-18,7.733333333333333,407,464,2020-08-18T00:43:00.000,76,251,80,57
856,2020-08-19,7.766666666666667,415,466,2020-08-19T00:40:00.000,96,205,114,51
857,2020-08-20,7.95,412,477,2020-08-20T00:18:30.000,91,268,53,65
858,2020-08-21,7.9,428,474,2020-08-21T00:26:00.000,94,241,93,46
859,2020-08-22,8.433333333333334,434,506,2020-08-22T01:42:00.000,105,248,81,72
860,2020-08-23,6.366666666666666,339,382,2020-08-23T02:44:00.000,93,167,79,43
861,2020-08-24,7.266666666666667,393,436,2020-08-24T01:44:00.000,95,192,106,43
862,2020-08-25,8.283333333333333,448,497,2020-08-25T00:15:30.000,92,281,75,49
863,2020-08-26,8.1,417,486,2020-08-26T00:32:30.000,101,264,52,69
864,2020-08-27,7.8,427,468,2020-08-27T00:36:00.000,102,211,114,41
865,2020-08-28,7.766666666666667,402,466,2020-08-28T00:41:30.000,80,256,66,64
866,2020-08-29,7.75,414,465,2020-08-29T00:56:00.000,113,174,127,51
867,2020-08-30,7.7,403,462,2020-08-30T02:46:00.000,107,210,86,59
868,2020-08-31,7.75,413,465,2020-08-31T00:46:30.000,118,179,116,52
869,2020-09-01,7.833333333333333,423,470,2020-09-01T00:51:00.000,86,242,95,47
870,2020-09-02,7.7,415,462,2020-09-02T00:53:30.000,92,226,97,47
871,2020-09-03,7.766666666666667,403,466,2020-09-03T00:59:00.000,50,257,96,63
872,2020-09-04,8.0,419,480,2020-09-04T00:21:30.000,118,202,99,61
873,2020-09-05,8.0,397,480,2020-09-05T02:23:30.000,82,220,95,83
874,2020-09-06,7.7,410,462,2020-09-06T01:56:00.000,95,200,115,52
875,2020-09-07,7.333333333333333,389,440,2020-09-07T04:15:00.000,99,230,60,51
876,2020-09-08,9.483333333333333,494,569,2020-09-07T23:24:00.000,96,288,110,75
877,2020-09-09,8.383333333333333,463,503,2020-09-09T00:38:00.000,113,216,134,40
878,2020-09-10,8.016666666666667,438,481,2020-09-10T01:11:00.000,76,244,118,43
879,2020-09-12,8.7,454,522,2020-09-12T00:38:30.000,99,256,99,68
880,2020-09-13,9.216666666666667,491,553,2020-09-13T00:40:30.000,78,272,141,62
881,2020-09-14,7.9,418,474,2020-09-14T01:05:30.000,83,236,99,56
882,2020-09-15,8.383333333333333,436,503,2020-09-15T00:37:00.000,80,295,61,67
883,2020-09-16,7.583333333333333,408,455,2020-09-16T00:41:00.000,87,205,116,47
884,2020-09-17,7.866666666666666,421,472,2020-09-17T00:41:00.000,126,211,84,51
885,2020-09-18,7.666666666666667,418,460,2020-09-18T00:56:30.000,97,244,77,42
886,2020-09-19,8.483333333333333,459,509,2020-09-19T01:42:30.000,120,224,115,50
887,2020-09-20,7.5,398,450,2020-09-20T02:17:00.000,95,197,106,52
888,2020-09-21,8.216666666666667,433,493,2020-09-21T00:23:00.000,71,275,87,60
889,2020-09-22,9.116666666666667,457,547,2020-09-21T23:28:30.000,91,263,103,90
890,2020-09-23,8.35,442,501,2020-09-23T00:29:00.000,120,217,105,59
891,2020-09-24,7.866666666666666,410,472,2020-09-24T00:49:30.000,70,237,103,62
892,2020-09-25,8.516666666666667,454,511,2020-09-25T00:22:30.000,97,270,87,57
893,2020-09-26,6.55,342,393,2020-09-26T05:24:00.000,66,192,84,51
894,2020-09-27,9.933333333333334,529,596,2020-09-27T00:44:00.000,99,335,95,67
895,2020-09-28,7.816666666666666,412,469,2020-09-28T00:52:30.000,86,244,82,57
896,2020-09-29,7.633333333333334,396,458,2020-09-29T01:04:00.000,85,227,84,62
897,2020-09-30,7.6,398,456,2020-09-30T01:22:00.000,114,204,80,58
898,2020-10-01,7.6,400,456,2020-10-01T01:27:30.000,90,221,89,56
899,2020-10-02,8.283333333333333,445,497,2020-10-02T00:31:00.000,94,219,132,52
900,2020-10-03,7.6,392,456,2020-10-03T02:18:00.000,88,219,85,64
901,2020-10-04,8.666666666666666,472,520,2020-10-04T02:11:00.000,121,200,151,48
902,2020-10-05,7.483333333333333,401,449,2020-10-05T01:18:00.000,73,236,92,48
903,2020-10-06,7.65,391,459,2020-10-06T01:14:30.000,71,228,92,68
904,2020-10-07,8.016666666666667,419,481,2020-10-07T00:55:30.000,102,242,75,62
905,2020-10-08,8.133333333333333,418,488,2020-10-08T00:50:30.000,92,249,77,70
906,2020-10-10,8.7,450,522,2020-10-10T01:11:00.000,89,277,84,72
907,2020-10-11,8.35,435,501,2020-10-11T00:53:00.000,79,277,79,66
908,2020-10-12,8.366666666666667,432,502,2020-10-12T00:22:30.000,108,223,101,70
909,2020-10-13,8.8,468,528,2020-10-13T00:08:00.000,122,246,100,60
910,2020-10-14,7.95,411,477,2020-10-14T01:01:30.000,94,222,95,66
911,2020-10-15,7.866666666666666,404,472,2020-10-15T01:07:30.000,99,205,100,68
912,2020-10-16,7.883333333333334,419,473,2020-10-16T01:07:00.000,95,257,67,54
913,2020-10-17,9.083333333333334,495,545,2020-10-17T01:11:30.000,76,326,93,50
914,2020-10-18,8.05,426,483,2020-10-18T02:56:00.000,84,248,94,57
915,2020-10-19,7.716666666666667,397,463,2020-10-19T01:33:30.000,74,227,96,66
916,2020-10-20,7.8,398,468,2020-10-20T00:55:00.000,103,197,98,70
917,2020-10-21,8.533333333333333,421,512,2020-10-21T01:10:30.000,124,206,91,91
918,2020-10-22,8.166666666666666,430,490,2020-10-22T00:54:00.000,92,247,91,60
919,2020-10-23,8.166666666666666,424,490,2020-10-23T00:55:30.000,87,234,103,66
920,2020-10-24,7.716666666666667,420,463,2020-10-24T02:49:30.000,100,212,108,43
921,2020-10-25,9.816666666666666,531,589,2020-10-25T02:19:30.000,96,313,122,58
922,2020-10-26,8.133333333333333,446,488,2020-10-26T01:04:30.000,82,254,110,42
923,2020-10-27,7.816666666666666,423,469,2020-10-27T01:19:00.000,108,218,97,46
924,2020-10-28,8.416666666666666,451,505,2020-10-28T01:08:00.000,112,239,100,54
925,2020-10-29,7.283333333333333,374,437,2020-10-29T01:33:30.000,97,197,80,63
926,2020-10-31,7.516666666666667,419,451,2020-10-31T03:08:00.000,118,213,88,32
927,2020-11-01,4.033333333333333,205,242,2020-11-01T02:19:00.000,41,160,4,37
928,2020-11-02,9.783333333333333,445,587,2020-11-01T22:30:00.000,57,337,51,142
929,2020-11-03,7.316666666666666,378,439,2020-11-03T01:24:30.000,91,189,98,61
930,2020-11-04,7.75,430,465,2020-11-04T01:29:00.000,90,204,136,35
931,2020-11-05,7.2,389,432,2020-11-05T02:19:00.000,79,176,134,43
932,2020-11-06,7.066666666666666,367,424,2020-11-06T02:33:30.000,76,197,94,57
933,2020-11-07,7.983333333333333,428,479,2020-11-07T03:42:00.000,121,218,89,51
934,2020-11-08,6.566666666666666,360,394,2020-11-08T03:00:30.000,99,186,75,34
935,2020-11-09,7.533333333333333,400,452,2020-11-09T02:04:00.000,73,251,76,52
936,2020-11-10,7.266666666666667,365,436,2020-11-10T01:21:30.000,103,174,88,71
937,2020-11-11,7.883333333333334,422,473,2020-11-11T01:44:00.000,103,219,100,51
938,2020-11-12,9.433333333333334,511,566,2020-11-12T00:19:30.000,112,291,108,55
939,2020-11-13,7.9,404,474,2020-11-13T01:24:00.000,103,203,98,70
940,2020-11-14,7.7,415,462,2020-11-14T03:19:00.000,73,225,117,47
941,2020-11-16,8.333333333333334,425,500,2020-11-16T00:54:30.000,86,252,87,75
942,2020-11-17,6.766666666666667,362,406,2020-11-17T02:08:00.000,65,225,72,44
943,2020-11-18,8.966666666666667,489,538,2020-11-18T00:55:00.000,110,265,114,49
944,2020-11-19,8.4,457,504,2020-11-19T00:37:30.000,94,273,90,47
945,2020-11-20,7.85,419,471,2020-11-20T01:02:00.000,102,228,89,52
946,2020-11-21,7.1,385,426,2020-11-21T04:06:00.000,110,188,87,41
947,2020-11-23,9.683333333333334,483,581,2020-11-22T23:35:30.000,97,291,95,98
948,2020-11-24,6.116666666666666,328,367,2020-11-24T02:12:30.000,94,164,70,39
949,2020-11-25,11.15,569,669,2020-11-24T22:34:00.000,89,357,123,100
950,2020-11-26,9.1,490,546,2020-11-26T02:05:30.000,104,248,138,56
951,2020-11-27,7.75,420,465,2020-11-27T02:47:30.000,66,261,93,45
952,2020-11-28,8.133333333333333,439,488,2020-11-28T02:49:00.000,96,257,86,49
953,2020-11-29,8.266666666666667,436,496,2020-11-29T02:23:00.000,107,244,85,60
954,2020-11-30,8.15,429,489,2020-11-30T01:03:00.000,83,255,91,60
955,2020-12-01,6.816666666666666,355,409,2020-12-01T01:50:00.000,101,154,100,54
956,2020-12-02,8.15,428,489,2020-12-02T01:15:30.000,92,244,92,61
957,2020-12-03,7.933333333333334,412,476,2020-12-03T01:26:30.000,86,219,107,64
958,2020-12-04,8.4,441,504,2020-12-04T00:47:00.000,115,245,81,63
959,2020-12-05,7.55,402,453,2020-12-05T02:48:00.000,89,203,110,51
960,2020-12-06,8.466666666666667,436,508,2020-12-06T02:01:00.000,110,263,63,72
961,2020-12-07,7.95,416,477,2020-12-07T01:30:00.000,80,239,97,61
962,2020-12-08,7.683333333333334,415,461,2020-12-08T01:02:00.000,82,242,91,46
963,2020-12-09,7.716666666666667,413,463,2020-12-09T01:39:00.000,85,224,104,50
964,2020-12-11,7.333333333333333,377,440,2020-12-11T02:03:00.000,89,197,91,63
965,2020-12-12,7.633333333333334,385,458,2020-12-12T04:33:00.000,92,211,82,73
966,2020-12-13,7.716666666666667,408,463,2020-12-13T04:43:30.000,89,216,103,55
967,2020-12-14,7.533333333333333,406,452,2020-12-14T01:46:30.000,86,246,74,46
968,2020-12-15,8.883333333333333,456,533,2020-12-14T23:55:30.000,91,263,102,77
969,2020-12-16,10.383333333333333,513,623,2020-12-15T23:07:00.000,124,302,87,110
970,2020-12-17,8.35,456,501,2020-12-17T01:19:00.000,99,218,139,45
971,2020-12-18,8.05,437,483,2020-12-18T01:18:30.000,128,184,125,46
972,2020-12-19,7.3,401,438,2020-12-19T02:46:00.000,114,175,112,37
973,2020-12-20,6.866666666666666,369,412,2020-12-20T04:58:00.000,77,194,98,43
974,2020-12-21,7.733333333333333,406,464,2020-12-21T01:46:00.000,94,220,92,58
975,2020-12-22,7.883333333333334,421,473,2020-12-22T01:24:30.000,76,221,124,52
976,2020-12-23,8.116666666666667,426,487,2020-12-23T01:30:00.000,65,260,101,61
977,2020-12-27,9.3,452,558,2020-12-27T00:37:00.000,59,359,34,106
978,2020-12-28,10.166666666666666,515,610,2020-12-27T23:22:00.000,60,353,102,95
979,2020-12-29,9.633333333333333,478,578,2020-12-28T23:42:00.000,50,328,100,100
980,2020-12-30,7.566666666666666,419,454,2020-12-30T01:42:30.000,76,237,106,35
981,2020-12-31,7.2,388,432,2020-12-31T02:26:30.000,91,207,90,44
982,2021-01-01,8.883333333333333,458,533,2021-01-01T04:58:30.000,110,231,117,75
983,2021-01-02,9.783333333333333,498,587,2021-01-02T00:29:00.000,66,306,126,89
984,2021-01-03,7.733333333333333,409,464,2021-01-03T04:08:00.000,75,281,53,55
985,2021-01-04,9.35,447,561,2021-01-04T00:27:00.000,56,292,99,114
986,2021-01-05,7.683333333333334,417,461,2021-01-05T01:10:00.000,77,230,110,44
987,2021-01-06,8.216666666666667,449,493,2021-01-06T01:25:30.000,109,247,93,44
988,2021-01-09,7.75,410,465,2021-01-09T02:43:00.000,119,178,113,55
989,2021-01-10,8.416666666666666,447,505,2021-01-10T02:23:30.000,94,219,134,58
990,2021-01-11,7.75,422,465,2021-01-11T01:40:30.000,81,232,109,43
991,2021-01-12,6.933333333333334,358,416,2021-01-12T01:53:00.000,78,189,91,58
992,2021-01-13,8.016666666666667,410,481,2021-01-13T02:00:00.000,80,238,92,71
993,2021-01-14,10.583333333333334,532,635,2021-01-13T23:09:00.000,86,370,76,103
994,2021-01-15,8.283333333333333,452,497,2021-01-15T01:26:00.000,128,216,108,45
995,2021-01-16,7.533333333333333,409,452,2021-01-16T02:39:00.000,134,158,117,43
996,2021-01-17,7.95,421,477,2021-01-17T03:40:00.000,118,213,90,56
997,2021-01-18,9.716666666666667,484,583,2021-01-17T23:52:00.000,66,352,66,99
998,2021-01-19,7.066666666666666,377,424,2021-01-19T01:44:30.000,73,234,70,47
999,2021-01-20,7.95,423,477,2021-01-20T01:42:00.000,75,272,76,54
1000,2021-01-21,7.766666666666667,416,466,2021-01-21T01:31:00.000,122,201,93,50
1001,2021-01-23,8.333333333333334,437,500,2021-01-23T02:52:30.000,105,215,117,63
1002,2021-01-24,7.566666666666666,407,454,2021-01-24T03:27:00.000,110,184,113,47
1003,2021-01-25,7.683333333333334,406,461,2021-01-25T01:21:30.000,78,224,104,55
1004,2021-01-26,6.0,322,360,2021-01-26T03:15:00.000,80,174,68,38
1005,2021-01-27,9.633333333333333,508,578,2021-01-26T23:14:30.000,93,283,132,70
1006,2021-01-28,10.116666666666667,463,607,2021-01-27T23:02:00.000,96,312,55,144
1007,2021-01-29,10.1,495,606,2021-01-28T23:21:30.000,92,296,107,111
1008,2021-01-30,8.233333333333333,450,494,2021-01-30T02:35:00.000,115,231,104,44
1009,2021-01-31,7.666666666666667,390,460,2021-01-31T04:10:30.000,112,194,84,70
1010,2021-02-01,9.15,486,549,2021-02-01T01:26:30.000,88,305,93,63
1011,2021-02-02,7.166666666666667,372,430,2021-02-02T02:27:00.000,69,233,70,58
1012,2021-02-03,7.766666666666667,407,466,2021-02-03T01:00:30.000,96,213,98,59
1013,2021-02-04,6.95,378,417,2021-02-04T02:55:30.000,97,198,83,39
1014,2021-02-05,7.183333333333334,391,431,2021-02-05T02:19:30.000,82,219,90,40
1015,2021-02-06,6.9,374,414,2021-02-06T04:25:00.000,89,191,94,40
1016,2021-02-07,8.133333333333333,427,488,2021-02-07T03:14:00.000,119,218,90,61
1017,2021-02-08,8.066666666666666,437,484,2021-02-08T01:55:00.000,53,267,117,47
1018,2021-02-09,8.166666666666666,434,490,2021-02-09T01:44:30.000,72,276,86,56
1019,2021-02-10,7.35,407,441,2021-02-10T02:28:00.000,85,215,107,34
1020,2021-02-11,7.633333333333334,415,458,2021-02-11T01:56:30.000,100,214,101,43
1021,2021-02-12,7.566666666666666,416,454,2021-02-12T02:22:00.000,103,209,104,38
1022,2021-02-13,8.466666666666667,467,508,2021-02-13T03:06:30.000,126,234,107,41
1023,2021-02-14,6.716666666666667,368,403,2021-02-14T03:50:00.000,92,198,78,35
1024,2021-02-15,7.75,436,465,2021-02-15T02:03:00.000,103,230,103,29
1025,2021-02-16,7.766666666666667,428,466,2021-02-16T02:07:00.000,81,254,93,38
1026,2021-02-17,7.6,393,456,2021-02-17T02:20:30.000,119,191,83,63
1027,2021-02-18,6.9,372,414,2021-02-18T01:55:00.000,52,252,68,42
1028,2021-02-19,7.25,383,435,2021-02-19T02:24:30.000,103,227,53,52
1029,2021-02-20,6.833333333333333,354,410,2021-02-20T02:40:00.000,78,205,71,56
1030,2021-02-21,7.883333333333334,421,473,2021-02-21T02:14:00.000,103,205,113,52
1031,2021-02-22,7.816666666666666,415,469,2021-02-22T01:56:30.000,89,229,97,54
1032,2021-02-23,8.25,452,495,2021-02-23T01:56:00.000,92,261,99,43
1033,2021-02-24,7.733333333333333,424,464,2021-02-24T02:14:00.000,115,208,101,40
1034,2021-02-25,8.45,460,507,2021-02-25T01:16:00.000,107,243,110,47
1035,2021-02-26,8.2,450,492,2021-02-26T01:45:00.000,104,231,115,42
1036,2021-02-27,7.6,410,456,2021-02-27T03:26:00.000,122,163,125,46
1037,2021-02-28,7.2,391,432,2021-02-28T04:41:00.000,73,252,66,41
1038,2021-03-01,8.7,463,522,2021-03-01T02:02:30.000,63,283,117,59
1039,2021-03-03,7.616666666666666,409,457,2021-03-03T02:18:30.000,77,241,91,48
1040,2021-03-04,9.016666666666667,477,541,2021-03-04T02:11:00.000,100,283,94,64
1041,2021-03-05,6.666666666666667,362,400,2021-03-05T02:07:00.000,87,228,47,38
1042,2021-03-06,7.383333333333334,407,443,2021-03-06T03:39:00.000,121,202,84,36
1043,2021-03-07,8.533333333333333,438,512,2021-03-07T04:30:00.000,93,241,104,74
1044,2021-03-08,7.8,417,468,2021-03-08T02:20:00.000,109,215,93,51
1045,2021-03-09,7.116666666666666,378,427,2021-03-09T02:27:00.000,83,227,68,49
1046,2021-03-10,7.233333333333333,383,434,2021-03-10T02:49:00.000,73,231,79,51
1047,2021-03-11,7.6,416,456,2021-03-11T02:22:30.000,91,203,122,40
1048,2021-03-12,7.333333333333333,393,440,2021-03-12T02:17:30.000,96,210,87,47
1049,2021-03-13,6.266666666666667,337,376,2021-03-13T05:57:30.000,72,192,73,39
1050,2021-03-14,7.583333333333333,416,455,2021-03-14T04:02:00.000,92,217,107,39
1051,2021-03-15,7.733333333333333,429,464,2021-03-15T02:17:30.000,118,190,121,35
1052,2021-03-16,6.8,352,408,2021-03-16T02:21:00.000,102,193,57,56
1053,2021-03-17,7.966666666666667,428,478,2021-03-17T01:35:30.000,107,228,93,50
1054,2021-03-18,7.283333333333333,392,437,2021-03-18T02:16:30.000,103,217,72,45
1055,2021-03-19,6.65,359,399,2021-03-19T02:17:00.000,73,214,72,40
1056,2021-03-20,6.833333333333333,358,410,2021-03-20T03:45:30.000,76,195,87,52
1057,2021-03-21,7.45,412,447,2021-03-21T03:03:00.000,75,238,99,35
1058,2021-03-22,7.65,409,459,2021-03-22T01:51:30.000,101,229,79,50
1059,2021-03-23,4.233333333333333,231,254,2021-03-23T02:00:00.000,32,144,55,23
1060,2021-03-24,7.616666666666666,404,457,2021-03-24T01:52:30.000,65,248,91,53
1061,2021-03-25,7.566666666666666,406,454,2021-03-25T02:17:30.000,88,220,98,48
1062,2021-03-26,7.75,404,465,2021-03-26T01:43:00.000,112,188,104,61
1063,2021-03-27,7.316666666666666,399,439,2021-03-27T01:44:00.000,108,193,98,40
1064,2021-03-28,8.983333333333333,484,539,2021-03-28T01:53:30.000,127,273,84,55
1065,2021-03-29,7.616666666666666,418,457,2021-03-29T01:42:30.000,85,231,102,39
1066,2021-03-30,8.033333333333333,441,482,2021-03-30T01:00:00.000,121,200,120,41
1067,2021-03-31,7.583333333333333,405,455,2021-03-31T01:26:30.000,71,221,113,50
1068,2021-04-01,7.05,379,423,2021-04-01T01:54:30.000,98,180,101,44
1069,2021-04-02,7.316666666666666,391,439,2021-04-02T01:34:30.000,78,196,117,48
1070,2021-04-03,7.083333333333333,385,425,2021-04-03T04:01:30.000,80,198,107,40
1071,2021-04-04,8.75,469,525,2021-04-04T03:01:00.000,87,258,124,56
1072,2021-04-05,7.4,388,444,2021-04-05T01:50:30.000,65,223,100,56
1073,2021-04-06,6.616666666666666,359,397,2021-04-06T02:08:00.000,77,205,77,38
1074,2021-04-07,7.15,383,429,2021-04-07T00:58:00.000,89,207,87,46
1075,2021-04-08,7.533333333333333,398,452,2021-04-08T01:12:00.000,105,222,71,54
1076,2021-04-09,7.4,391,444,2021-04-09T00:55:00.000,88,209,94,53
1077,2021-04-10,8.633333333333333,457,518,2021-04-10T02:45:30.000,123,259,75,61
1078,2021-04-11,7.133333333333334,383,428,2021-04-11T03:41:00.000,87,214,82,45
1079,2021-04-12,8.55,425,513,2021-04-12T01:10:00.000,103,238,84,88
1080,2021-04-13,7.05,362,423,2021-04-13T02:08:30.000,85,206,71,61
1081,2021-04-14,7.316666666666666,390,439,2021-04-14T01:46:00.000,97,220,73,49
1082,2021-04-15,7.083333333333333,388,425,2021-04-15T01:52:30.000,91,204,93,37
1083,2021-04-16,8.166666666666666,416,490,2021-04-16T00:54:00.000,103,247,66,74
1084,2021-04-17,7.45,405,447,2021-04-17T01:52:30.000,77,225,103,42
1085,2021-04-18,3.966666666666667,204,238,2021-04-18T03:27:00.000,59,116,29,34
1086,2021-04-19,8.716666666666667,449,523,2021-04-19T00:07:00.000,111,251,87,74
1087,2021-04-20,7.166666666666667,378,430,2021-04-20T02:01:00.000,103,193,82,52
1088,2021-04-21,7.066666666666666,372,424,2021-04-21T01:57:00.000,74,206,92,52
1089,2021-04-22,7.383333333333334,396,443,2021-04-22T01:51:30.000,118,161,117,47
1090,2021-04-23,7.266666666666667,392,436,2021-04-23T01:00:30.000,85,227,80,44
1091,2021-04-24,5.65,300,339,2021-04-24T02:41:00.000,102,123,75,39
1092,2021-04-25,6.383333333333334,331,383,2021-04-25T02:25:00.000,61,195,75,52
1093,2021-04-26,10.183333333333334,552,611,2021-04-25T22:53:00.000,111,313,128,59
1094,2021-04-27,7.3,379,438,2021-04-27T01:11:00.000,122,150,107,59
1095,2021-04-28,7.533333333333333,386,452,2021-04-28T00:45:30.000,104,220,62,66
1096,2021-04-29,7.283333333333333,387,437,2021-04-29T01:16:00.000,69,220,98,50
1097,2021-04-30,6.633333333333334,348,398,2021-04-30T01:57:00.000,92,171,85,50
1098,2021-05-01,7.366666666666666,387,442,2021-05-01T02:23:30.000,101,168,118,55
1099,2021-05-02,7.766666666666667,414,466,2021-05-02T02:28:00.000,65,261,88,52
1100,2021-05-03,7.75,428,465,2021-05-03T01:01:00.000,111,180,137,37
1101,2021-05-04,7.733333333333333,414,464,2021-05-04T00:35:30.000,123,213,78,50
1102,2021-05-05,7.916666666666667,430,475,2021-05-05T00:58:30.000,120,214,96,45
1103,2021-05-06,7.833333333333333,412,470,2021-05-06T01:03:00.000,87,223,102,58
1104,2021-05-07,7.533333333333333,390,452,2021-05-07T01:42:00.000,86,216,88,62
1105,2021-05-08,7.983333333333333,428,479,2021-05-08T02:09:00.000,125,187,116,51
1106,2021-05-09,8.266666666666667,446,496,2021-05-09T01:31:00.000,116,201,129,50
1107,2021-05-10,7.666666666666667,411,460,2021-05-10T00:47:30.000,127,198,86,49
1108,2021-05-11,8.083333333333334,446,485,2021-05-11T00:18:30.000,96,215,135,39
1109,2021-05-12,7.483333333333333,387,449,2021-05-12T01:08:30.000,103,237,47,62
1110,2021-05-13,7.116666666666666,385,427,2021-05-13T01:12:00.000,91,194,100,42
1111,2021-05-14,7.166666666666667,378,430,2021-05-14T01:52:30.000,97,185,96,52
1112,2021-05-15,7.983333333333333,393,479,2021-05-15T03:08:00.000,82,235,76,86
1113,2021-05-16,10.183333333333334,541,611,2021-05-15T23:50:30.000,103,323,115,70
1114,2021-05-17,8.05,424,483,2021-05-17T01:18:30.000,77,252,95,59
1115,2021-05-18,6.433333333333334,343,386,2021-05-18T02:01:30.000,67,184,92,43
1116,2021-05-19,7.666666666666667,416,460,2021-05-19T01:40:00.000,119,192,105,44
1117,2021-05-20,7.883333333333334,423,473,2021-05-20T01:28:00.000,107,213,103,50
1118,2021-05-21,7.1,377,426,2021-05-21T02:07:00.000,105,176,96,49
1119,2021-05-22,7.7,414,462,2021-05-22T02:47:00.000,56,247,111,48
1120,2021-05-23,7.483333333333333,401,449,2021-05-23T03:35:00.000,106,172,123,48
1121,2021-05-24,7.833333333333333,422,470,2021-05-24T01:20:30.000,117,211,94,48
1122,2021-05-25,7.183333333333334,388,431,2021-05-25T01:15:30.000,60,245,83,43
1123,2021-05-26,9.966666666666667,524,598,2021-05-25T23:29:00.000,81,337,106,74
1124,2021-05-27,7.616666666666666,405,457,2021-05-27T02:14:30.000,94,193,118,52
1125,2021-05-28,7.183333333333334,382,431,2021-05-28T01:20:30.000,109,192,81,49
1126,2021-05-29,7.85,422,471,2021-05-29T02:00:00.000,64,278,80,49
1127,2021-05-30,7.65,411,459,2021-05-30T01:22:00.000,94,202,115,48
1128,2021-05-31,7.833333333333333,432,470,2021-05-31T02:59:00.000,80,226,126,38
1129,2021-06-01,7.516666666666667,399,451,2021-06-01T01:28:00.000,84,226,89,52
1130,2021-06-02,7.85,429,471,2021-06-02T01:37:30.000,53,236,140,42
1131,2021-06-03,8.216666666666667,449,493,2021-06-03T01:06:30.000,59,272,118,44
1132,2021-06-04,8.266666666666667,423,496,2021-06-04T00:52:00.000,54,293,76,73
1133,2021-06-05,9.633333333333333,464,578,2021-06-05T01:05:30.000,56,326,82,114
1134,2021-06-06,9.2,423,552,2021-06-05T23:12:00.000,58,298,67,129
1135,2021-06-07,8.2,446,492,2021-06-07T00:13:30.000,69,265,112,46
1136,2021-06-08,6.483333333333333,353,389,2021-06-08T01:40:30.000,38,241,74,36
1137,2021-06-09,7.3,397,438,2021-06-09T01:50:30.000,84,209,104,41
1138,2021-06-10,7.383333333333334,382,443,2021-06-10T02:06:00.000,55,213,114,61
1139,2021-06-11,7.2,375,432,2021-06-11T01:36:30.000,109,190,76,57
1140,2021-06-12,7.433333333333334,392,446,2021-06-12T03:30:00.000,79,219,94,54
1141,2021-06-13,8.35,434,501,2021-06-13T03:21:30.000,76,252,106,67
1142,2021-06-14,9.0,481,540,2021-06-14T00:44:30.000,69,332,80,59
1143,2021-06-15,7.366666666666666,384,442,2021-06-15T01:55:00.000,56,249,79,58
1144,2021-06-16,7.483333333333333,371,449,2021-06-16T01:00:00.000,36,247,88,78
1145,2021-06-17,7.683333333333334,416,461,2021-06-17T01:46:00.000,82,233,101,45
1146,2021-06-18,7.5,404,450,2021-06-18T01:31:30.000,88,210,106,46
1147,2021-06-19,5.816666666666666,311,349,2021-06-19T03:42:00.000,40,173,98,38
1148,2021-06-20,7.983333333333333,425,479,2021-06-20T01:32:30.000,63,257,105,54
1149,2021-06-21,7.833333333333333,413,470,2021-06-21T01:42:30.000,44,319,50,57
1150,2021-06-22,7.583333333333333,389,455,2021-06-22T01:44:30.000,77,205,107,66
1151,2021-06-23,7.433333333333334,375,446,2021-06-23T01:40:00.000,72,257,46,71
1152,2021-06-24,6.9,369,414,2021-06-24T02:13:30.000,78,194,97,45
1153,2021-06-25,7.183333333333334,385,431,2021-06-25T01:49:00.000,61,223,101,46
1154,2021-06-26,4.283333333333333,233,257,2021-06-26T00:42:00.000,46,115,72,24
1155,2021-06-30,7.95,406,477,2021-06-30T01:07:00.000,60,253,93,71
1156,2021-07-01,7.633333333333334,387,458,2021-07-01T01:33:30.000,83,246,58,71
1157,2021-07-02,7.383333333333334,370,443,2021-07-02T02:13:30.000,81,237,52,73
1158,2021-07-03,6.4,343,384,2021-07-03T03:55:30.000,56,219,68,41
1159,2021-07-04,6.816666666666666,350,409,2021-07-04T03:03:00.000,92,160,98,59
1160,2021-07-05,8.366666666666667,441,502,2021-07-05T03:06:00.000,89,238,114,61
1161,2021-07-06,7.383333333333334,395,443,2021-07-06T01:36:00.000,72,218,105,48
1162,2021-07-07,7.55,377,453,2021-07-07T01:43:00.000,59,265,53,76
1163,2021-07-08,7.45,409,447,2021-07-08T02:17:30.000,91,178,140,38
1164,2021-07-09,7.2,375,432,2021-07-09T02:50:00.000,54,271,50,57
1165,2021-07-10,7.5,399,450,2021-07-10T04:37:00.000,86,221,92,51
1166,2021-07-11,7.683333333333334,411,461,2021-07-11T04:56:30.000,93,222,96,50
1167,2021-07-12,7.55,376,453,2021-07-12T02:16:00.000,90,214,72,77
1168,2021-07-13,8.566666666666666,464,514,2021-07-13T00:59:00.000,95,274,95,50
1169,2021-07-14,7.3,382,438,2021-07-14T02:08:00.000,96,196,90,56
1170,2021-07-15,7.633333333333334,408,458,2021-07-15T01:44:30.000,92,205,111,50
1171,2021-07-16,7.533333333333333,406,452,2021-07-16T01:58:00.000,80,231,95,46
1172,2021-07-17,3.533333333333333,175,212,2021-07-17T04:32:00.000,44,117,14,37
1173,2021-07-18,5.666666666666667,281,340,2021-07-18T05:45:00.000,40,206,35,59
1174,2021-07-19,8.433333333333334,436,506,2021-07-19T01:07:00.000,101,272,63,70
1175,2021-07-20,6.783333333333333,362,407,2021-07-20T01:51:00.000,70,252,40,45
1176,2021-07-21,8.116666666666667,424,487,2021-07-21T01:13:00.000,102,237,85,63
1177,2021-07-22,6.733333333333333,342,404,2021-07-22T03:54:30.000,85,165,92,62
1178,2021-07-23,6.633333333333334,354,398,2021-07-23T03:08:30.000,97,169,88,44
1179,2021-07-24,6.383333333333334,331,383,2021-07-24T01:35:00.000,52,199,80,52
1180,2021-07-25,6.466666666666667,325,388,2021-07-25T04:19:30.000,70,191,64,63
1181,2021-07-26,7.466666666666667,395,448,2021-07-26T01:50:30.000,109,183,103,53
1182,2021-07-27,7.333333333333333,391,440,2021-07-27T01:21:00.000,62,201,128,49
1183,2021-07-28,7.583333333333333,405,455,2021-07-28T01:32:00.000,71,215,119,50
1184,2021-07-29,7.416666666666667,368,445,2021-07-29T01:45:00.000,71,261,36,77
1185,2021-07-30,8.033333333333333,404,482,2021-07-30T00:55:00.000,85,240,79,78
1186,2021-07-31,7.466666666666667,377,448,2021-07-31T00:23:00.000,47,281,49,71
1187,2021-08-01,7.133333333333334,393,428,2021-08-01T01:43:30.000,99,188,106,35
1188,2021-08-02,7.516666666666667,406,451,2021-08-02T01:37:30.000,81,231,94,45
1189,2021-08-03,5.816666666666666,304,349,2021-08-03T02:54:30.000,60,206,38,45
1190,2021-08-04,7.416666666666667,410,445,2021-08-04T01:59:00.000,89,235,86,35
1191,2021-08-05,3.683333333333333,196,221,2021-08-05T02:12:00.000,34,132,30,25
1192,2021-08-11,9.016666666666667,481,541,2021-08-11T00:02:00.000,108,255,118,60
1193,2021-08-12,7.233333333333333,384,434,2021-08-12T02:22:00.000,77,213,94,50
1194,2021-08-13,6.833333333333333,381,410,2021-08-13T01:26:00.000,89,146,146,29
1195,2021-08-14,6.166666666666667,319,370,2021-08-14T03:39:30.000,68,161,90,51
1196,2021-08-15,5.416666666666667,287,325,2021-08-15T05:07:00.000,37,144,106,38
1197,2021-08-16,9.383333333333333,503,563,2021-08-16T00:06:00.000,71,316,116,60
1198,2021-08-17,8.7,419,522,2021-08-17T00:06:30.000,59,243,117,103
1199,2021-08-18,9.983333333333333,494,599,2021-08-18T00:03:00.000,67,346,81,105
1200,2021-08-19,7.05,379,423,2021-08-19T02:54:00.000,82,223,74,44
1201,2021-08-20,7.25,381,435,2021-08-20T01:54:00.000,97,209,75,54
1202,2021-08-21,8.366666666666667,444,502,2021-08-21T02:36:00.000,116,174,154,58
1203,2021-08-23,6.666666666666667,349,400,2021-08-23T03:01:00.000,80,206,63,51
1204,2021-08-24,6.85,376,411,2021-08-24T02:07:00.000,96,174,106,35
1205,2021-08-25,8.8,441,528,2021-08-25T01:02:30.000,76,288,77,87
1206,2021-08-26,7.166666666666667,379,430,2021-08-26T02:30:30.000,53,260,66,51
1207,2021-08-27,6.95,375,417,2021-08-27T02:42:30.000,113,163,99,42
1208,2021-08-28,9.783333333333333,478,587,2021-08-27T23:50:00.000,60,348,70,109
1209,2021-08-29,6.533333333333333,339,392,2021-08-29T02:21:00.000,64,199,76,53
1210,2021-08-30,6.683333333333334,372,401,2021-08-30T03:10:00.000,78,203,91,29
1211,2021-08-31,6.0,319,360,2021-08-31T02:57:00.000,62,199,58,41
1212,2021-09-01,6.333333333333333,342,380,2021-09-01T02:27:30.000,49,186,107,38
1213,2021-09-02,7.033333333333333,380,422,2021-09-02T01:59:00.000,116,161,103,42
1214,2021-09-03,7.116666666666666,378,427,2021-09-03T02:27:00.000,97,174,107,49
1215,2021-09-04,4.016666666666667,209,241,2021-09-04T04:59:30.000,46,142,21,32
1216,2021-09-05,9.016666666666667,502,541,2021-09-05T01:45:30.000,90,289,123,39
1217,2021-09-06,6.733333333333333,377,404,2021-09-06T03:00:00.000,101,183,93,27
1218,2021-09-08,6.65,344,399,2021-09-08T01:31:30.000,88,174,82,55
1219,2021-09-09,8.316666666666666,439,499,2021-09-09T01:15:00.000,110,211,118,60
1220,2021-09-10,5.683333333333334,311,341,2021-09-10T03:28:00.000,77,159,75,30
1221,2021-09-11,7.283333333333333,403,437,2021-09-11T03:29:00.000,87,244,72,34
1222,2021-09-12,8.233333333333333,401,494,2021-09-11T23:48:30.000,86,265,50,93
1223,2021-09-13,9.5,455,570,2021-09-12T23:25:00.000,96,306,53,115
1224,2021-09-14,9.116666666666667,434,547,2021-09-13T23:28:00.000,88,285,61,113
1225,2021-09-16,7.833333333333333,416,470,2021-09-16T01:46:00.000,112,195,109,54
1226,2021-09-17,6.633333333333334,351,398,2021-09-17T02:18:00.000,103,135,113,47
1227,2021-09-18,6.55,357,393,2021-09-18T04:00:00.000,88,163,106,36
1228,2021-09-19,6.983333333333333,376,419,2021-09-19T04:08:00.000,88,204,84,43
1229,2021-09-20,6.75,361,405,2021-09-20T02:52:30.000,68,192,101,44
1230,2021-09-21,7.066666666666666,388,424,2021-09-21T01:52:30.000,73,197,118,36
1231,2021-09-22,7.4,401,444,2021-09-22T01:27:00.000,77,218,106,43
1232,2021-09-23,8.116666666666667,436,487,2021-09-23T01:01:30.000,119,207,110,51
1233,2021-09-24,7.9,437,474,2021-09-24T01:14:30.000,123,207,107,37
1234,2021-09-25,5.616666666666666,277,337,2021-09-25T05:10:00.000,77,142,58,60
1235,2021-09-26,6.633333333333334,341,398,2021-09-26T04:46:00.000,94,170,77,57
1236,2021-09-27,6.616666666666666,341,397,2021-09-27T03:23:00.000,59,215,67,56
1237,2021-09-28,7.083333333333333,353,425,2021-09-28T01:50:00.000,79,201,73,72
1238,2021-09-30,7.35,407,441,2021-09-30T02:24:00.000,127,156,124,34
1239,2021-10-01,7.066666666666666,373,424,2021-10-01T02:39:00.000,90,209,74,51
1240,2021-10-02,6.016666666666667,325,361,2021-10-02T03:27:00.000,59,180,86,36
1241,2021-10-03,7.433333333333334,389,446,2021-10-03T03:07:30.000,78,247,64,57
1242,2021-10-04,8.266666666666667,443,496,2021-10-04T01:25:30.000,105,247,91,53
1243,2021-10-05,7.433333333333334,396,446,2021-10-05T01:10:30.000,71,227,98,50
1244,2021-10-06,7.933333333333334,436,476,2021-10-06T01:15:30.000,121,203,112,40
1245,2021-10-07,7.65,400,459,2021-10-07T01:57:30.000,70,233,97,59
1246,2021-10-08,6.783333333333333,373,407,2021-10-08T02:29:00.000,101,184,88,34
1247,2021-10-09,7.0,381,420,2021-10-09T03:17:30.000,101,183,97,39
1248,2021-10-10,6.533333333333333,355,392,2021-10-10T03:25:00.000,95,183,77,37
1249,2021-10-11,7.316666666666666,397,439,2021-10-11T02:19:00.000,77,201,119,42
1250,2021-10-12,6.5,358,390,2021-10-12T01:45:00.000,66,213,79,32
1251,2021-10-14,8.25,430,495,2021-10-14T01:13:00.000,67,259,104,65
1252,2021-10-15,7.016666666666667,370,421,2021-10-15T01:27:00.000,73,197,100,51
1253,2021-10-19,3.0,153,180,2021-10-19T05:01:00.000,20,85,48,27
1254,2021-10-20,7.516666666666667,389,451,2021-10-20T01:18:00.000,88,225,76,62
1255,2021-10-21,7.05,374,423,2021-10-21T01:25:00.000,65,226,83,49
1256,2021-10-22,6.683333333333334,353,401,2021-10-22T02:52:00.000,75,186,92,48
1257,2021-10-23,7.116666666666666,371,427,2021-10-23T03:47:00.000,89,218,64,56
1258,2021-10-24,7.166666666666667,370,430,2021-10-24T08:02:30.000,106,264,0,60
1259,2021-10-25,3.2333333333333334,175,194,2021-10-25T08:01:00.000,27,148,0,19
1260,2021-10-26,10.0,518,600,2021-10-26T01:49:30.000,142,256,120,82
1261,2021-10-27,3.566666666666667,179,214,2021-10-27T07:46:00.000,53,126,0,35
1262,2021-10-28,13.333333333333334,662,800,2021-10-27T20:01:30.000,94,420,148,138
1263,2021-10-29,8.133333333333333,416,488,2021-10-29T01:57:30.000,76,285,55,72
1264,2021-10-30,11.383333333333333,562,683,2021-10-29T23:57:30.000,72,379,111,121
1265,2021-10-31,8.733333333333333,469,524,2021-10-31T04:21:30.000,120,246,103,55
1266,2021-11-01,6.883333333333334,369,413,2021-11-01T02:46:00.000,84,188,97,44
1267,2021-11-02,6.316666666666666,336,379,2021-11-02T01:59:00.000,51,193,92,43
1268,2021-11-03,7.583333333333333,422,455,2021-11-03T02:08:30.000,92,178,152,33
1269,2021-11-04,8.566666666666666,457,514,2021-11-04T01:00:00.000,110,222,125,57
1270,2021-11-06,6.183333333333334,338,371,2021-11-06T05:14:00.000,83,166,89,33
1271,2021-11-07,4.733333333333333,206,284,2021-11-07T12:11:00.000,46,160,0,78
1272,2021-11-08,5.933333333333334,319,356,2021-11-08T02:42:00.000,93,109,117,37
1273,2021-11-09,5.933333333333334,306,356,2021-11-09T03:07:00.000,86,155,65,50
1274,2021-11-10,6.183333333333334,334,371,2021-11-10T02:52:00.000,60,189,85,37
1275,2021-11-11,6.033333333333333,333,362,2021-11-11T01:08:30.000,99,125,109,29
1276,2021-11-12,6.966666666666667,380,418,2021-11-12T00:17:00.000,104,152,124,38
1277,2021-11-13,5.916666666666667,319,355,2021-11-13T04:34:00.000,63,173,83,36
1278,2021-11-14,9.5,517,570,2021-11-13T22:30:30.000,116,267,134,53
1279,2021-11-16,6.083333333333333,315,365,2021-11-16T02:12:00.000,63,189,63,50
1280,2021-11-17,6.233333333333333,342,374,2021-11-17T02:10:00.000,63,207,72,32
1281,2021-11-18,10.566666666666666,503,634,2021-11-17T23:21:30.000,74,329,100,131
1282,2021-11-19,5.933333333333334,325,356,2021-11-19T03:20:00.000,68,178,79,31
1283,2021-11-20,7.016666666666667,383,421,2021-11-20T03:53:00.000,86,199,98,38
1284,2021-11-21,3.1666666666666665,143,190,2021-11-21T08:10:00.000,0,137,6,47
1285,2021-11-22,8.933333333333334,470,536,2021-11-22T00:18:00.000,101,242,127,66
1286,2021-11-23,7.016666666666667,364,421,2021-11-23T01:30:00.000,56,229,79,57
1287,2021-11-24,7.766666666666667,408,466,2021-11-24T02:08:00.000,88,223,97,58
1288,2021-11-25,6.483333333333333,319,389,2021-11-25T02:13:30.000,73,175,71,70
1289,2021-11-26,7.366666666666666,388,442,2021-11-26T01:50:00.000,94,189,105,54
1290,2021-11-27,7.083333333333333,369,425,2021-11-27T03:57:00.000,68,231,70,56
1291,2021-11-28,7.316666666666666,392,439,2021-11-28T03:05:00.000,80,237,75,47
1292,2021-11-29,7.383333333333334,380,443,2021-11-29T02:13:00.000,66,184,130,63
1293,2021-11-30,6.55,342,393,2021-11-30T02:20:30.000,99,156,87,51
1294,2021-12-01,7.383333333333334,387,443,2021-12-01T02:20:00.000,75,227,85,56
1295,2021-12-02,7.833333333333333,412,470,2021-12-02T01:48:00.000,93,224,95,58
1296,2021-12-03,7.766666666666667,410,466,2021-12-03T01:42:00.000,70,276,64,56
1297,2021-12-04,8.116666666666667,429,487,2021-12-04T01:59:00.000,78,222,129,58
1298,2021-12-05,5.766666666666667,299,346,2021-12-05T07:54:00.000,100,178,21,47
1299,2021-12-06,8.5,456,510,2021-12-06T01:11:00.000,122,233,101,54
1300,2021-12-07,6.6,355,396,2021-12-07T01:24:00.000,47,190,118,41
1301,2021-12-08,7.583333333333333,413,455,2021-12-08T01:45:30.000,119,174,120,42
1302,2021-12-09,7.533333333333333,401,452,2021-12-09T01:43:00.000,109,204,88,51
1303,2021-12-10,7.683333333333334,411,461,2021-12-10T01:48:00.000,93,210,108,50
1304,2021-12-11,5.966666666666667,326,358,2021-12-11T04:32:00.000,88,178,60,32
1305,2021-12-12,9.366666666666667,505,562,2021-12-12T00:04:30.000,106,266,133,57
1306,2021-12-13,7.25,393,435,2021-12-13T02:07:30.000,74,225,94,42
1307,2021-12-14,6.233333333333333,337,374,2021-12-14T02:30:00.000,84,176,77,37
1308,2021-12-15,7.216666666666667,394,433,2021-12-15T02:25:30.000,69,239,86,39
1309,2021-12-16,6.9,365,414,2021-12-16T02:38:30.000,84,208,73,49
1310,2021-12-17,6.966666666666667,362,418,2021-12-17T04:08:00.000,78,220,64,56
1311,2021-12-18,7.35,390,441,2021-12-18T02:46:00.000,85,229,76,51
1312,2021-12-19,7.333333333333333,393,440,2021-12-19T03:06:00.000,86,228,79,47
1313,2021-12-20,6.866666666666666,363,412,2021-12-20T03:35:00.000,88,200,75,49
1314,2021-12-21,6.816666666666666,372,409,2021-12-21T04:12:00.000,86,200,86,37
1315,2021-12-22,7.216666666666667,365,433,2021-12-22T03:15:00.000,90,183,92,68
1316,2021-12-23,6.716666666666667,355,403,2021-12-23T03:15:00.000,77,178,100,48
1317,2021-12-24,8.083333333333334,428,485,2021-12-24T01:42:30.000,89,224,115,57
1318,2021-12-25,9.566666666666666,532,574,2021-12-25T01:15:00.000,118,305,109,42
1319,2021-12-26,7.933333333333334,432,476,2021-12-26T02:41:00.000,112,206,114,44
1320,2021-12-27,7.8,404,468,2021-12-27T01:47:00.000,96,178,130,64
1321,2021-12-28,6.983333333333333,371,419,2021-12-28T03:21:00.000,61,232,78,48
1322,2021-12-29,6.983333333333333,383,419,2021-12-29T02:29:00.000,68,218,97,36
1323,2021-12-30,7.85,395,471,2021-12-30T01:43:30.000,79,243,73,76
1324,2021-12-31,7.333333333333333,398,440,2021-12-31T02:49:00.000,78,247,73,42
1325,2022-01-01,7.983333333333333,375,479,2022-01-01T08:37:00.000,94,257,24,104
1326,2022-01-02,10.166666666666666,539,610,2022-01-01T23:38:00.000,111,291,137,71
1327,2022-01-03,7.1,346,426,2022-01-03T02:27:30.000,66,217,63,80
1328,2022-01-04,7.35,390,441,2022-01-04T02:25:00.000,98,204,88,51
1329,2022-01-05,7.35,400,441,2022-01-05T02:35:00.000,94,207,99,41
1330,2022-01-06,7.45,389,447,2022-01-06T02:17:00.000,108,211,70,58
1331,2022-01-07,7.05,361,423,2022-01-07T02:36:00.000,86,209,66,62
1332,2022-01-08,7.316666666666666,406,439,2022-01-08T05:40:00.000,117,185,104,33
1333,2022-01-09,4.183333333333334,209,251,2022-01-09T07:16:00.000,44,136,29,42
1334,2022-01-10,8.433333333333334,446,506,2022-01-10T01:43:00.000,106,247,93,60
1335,2022-01-11,7.416666666666667,382,445,2022-01-11T01:44:00.000,65,240,77,63
1336,2022-01-12,7.3,382,438,2022-01-12T02:30:30.000,89,208,85,56
1337,2022-01-13,6.933333333333334,370,416,2022-01-13T02:51:00.000,104,151,115,46
1338,2022-01-14,6.6,366,396,2022-01-14T02:18:30.000,88,174,104,30
1339,2022-01-15,7.083333333333333,369,425,2022-01-15T03:58:30.000,66,240,63,56
1340,2022-01-16,9.516666666666667,481,571,2022-01-16T04:17:00.000,99,336,46,90
1341,2022-01-17,7.566666666666666,427,454,2022-01-17T02:18:00.000,71,251,105,27
1342,2022-01-18,6.816666666666666,365,409,2022-01-18T02:44:00.000,85,188,92,44
1343,2022-01-19,7.583333333333333,406,455,2022-01-19T02:17:00.000,93,200,113,49
1344,2022-01-20,7.683333333333334,402,461,2022-01-20T02:46:00.000,107,182,113,59
1345,2022-01-21,7.25,391,435,2022-01-21T03:08:00.000,78,198,115,44
1346,2022-01-22,6.833333333333333,372,410,2022-01-22T05:34:00.000,102,184,86,38
1347,2022-01-23,6.833333333333333,365,410,2022-01-23T04:08:00.000,91,207,67,45
1348,2022-01-24,7.183333333333334,377,431,2022-01-24T02:47:00.000,87,211,79,54
1349,2022-01-25,7.283333333333333,397,437,2022-01-25T02:55:00.000,85,198,114,40
1350,2022-01-26,7.483333333333333,408,449,2022-01-26T03:00:00.000,116,159,133,41
1351,2022-01-27,6.266666666666667,342,376,2022-01-27T03:07:30.000,24,238,80,34
1352,2022-01-28,6.183333333333334,334,371,2022-01-28T03:04:30.000,82,173,79,37
1353,2022-01-29,8.616666666666667,461,517,2022-01-29T04:21:00.000,110,203,148,56
1354,2022-01-30,6.733333333333333,371,404,2022-01-30T03:43:00.000,79,192,100,33
1355,2022-01-31,6.883333333333334,368,413,2022-01-31T03:06:30.000,75,171,122,45
1356,2022-02-01,6.4,337,384,2022-02-01T02:20:30.000,70,198,69,47
1357,2022-02-02,6.8,379,408,2022-02-02T02:54:30.000,98,132,149,29
1358,2022-02-03,7.95,418,477,2022-02-03T02:32:00.000,135,152,131,59
1359,2022-02-04,7.266666666666667,387,436,2022-02-04T02:35:30.000,97,176,114,49
1360,2022-02-05,7.616666666666666,401,457,2022-02-05T01:48:00.000,98,232,71,56
1361,2022-02-06,7.983333333333333,415,479,2022-02-06T01:17:30.000,95,210,110,64
1362,2022-02-07,7.383333333333334,388,443,2022-02-07T02:35:00.000,97,186,105,55
1363,2022-02-08,7.5,406,450,2022-02-08T01:40:30.000,118,184,104,44
1364,2022-02-09,7.633333333333334,379,458,2022-02-09T01:25:00.000,87,254,38,79
1365,2022-02-10,7.333333333333333,405,440,2022-02-10T02:36:00.000,89,209,107,35
1366,2022-02-11,7.483333333333333,412,449,2022-02-11T02:23:00.000,85,216,111,37
1367,2022-02-12,7.6,406,456,2022-02-12T02:32:30.000,113,187,106,50
1368,2022-02-13,8.566666666666666,422,514,2022-02-13T01:27:00.000,88,235,99,92
1369,2022-02-14,7.2,381,432,2022-02-14T02:32:00.000,104,162,115,51
1370,2022-02-15,6.666666666666667,356,400,2022-02-15T02:35:00.000,83,191,82,44
1371,2022-02-16,7.75,436,465,2022-02-16T01:24:00.000,88,215,133,29
1372,2022-02-17,8.666666666666666,439,520,2022-02-17T00:45:30.000,95,216,128,81
1373,2022-02-18,6.933333333333334,383,416,2022-02-18T02:34:30.000,79,173,131,33
1374,2022-02-19,6.166666666666667,315,370,2022-02-19T06:21:30.000,76,172,67,55
1375,2022-02-20,7.7,431,462,2022-02-20T02:55:30.000,97,175,159,31
1376,2022-02-21,8.0,411,480,2022-02-21T02:00:00.000,98,217,96,69
1377,2022-02-22,9.816666666666666,520,589,2022-02-21T23:25:00.000,95,333,92,69
1378,2022-02-23,9.05,459,543,2022-02-22T23:27:30.000,82,342,35,84
1379,2022-02-24,6.233333333333333,315,374,2022-02-24T01:46:00.000,63,197,55,59
1380,2022-02-25,7.7,416,462,2022-02-25T01:56:30.000,75,241,100,46
1381,2022-02-26,7.366666666666666,390,442,2022-02-26T03:03:30.000,79,271,40,52
1382,2022-02-27,7.366666666666666,404,442,2022-02-27T02:12:30.000,97,213,94,38
1383,2022-02-28,6.183333333333334,345,371,2022-02-28T04:03:30.000,80,181,84,26
1384,2022-03-01,7.483333333333333,421,449,2022-03-01T01:24:00.000,117,174,130,28
1385,2022-03-02,5.583333333333333,314,335,2022-03-02T02:47:00.000,84,179,51,21
1386,2022-03-03,7.016666666666667,382,421,2022-03-03T01:35:30.000,87,188,107,39
1387,2022-03-04,6.766666666666667,371,406,2022-03-04T03:12:30.000,92,175,104,35
1388,2022-03-05,5.516666666666667,285,331,2022-03-05T05:36:00.000,85,192,8,46
1389,2022-03-06,7.9,437,474,2022-03-06T02:55:00.000,97,196,144,37
1390,2022-03-07,6.966666666666667,385,418,2022-03-07T03:10:30.000,84,171,130,33
1391,2022-03-08,6.483333333333333,325,389,2022-03-08T02:24:30.000,71,179,75,64
1392,2022-03-09,6.75,380,405,2022-03-09T02:37:00.000,82,179,119,25
1393,2022-03-10,7.6,420,456,2022-03-10T02:34:30.000,79,212,129,36
1394,2022-03-11,6.233333333333333,330,374,2022-03-11T02:40:00.000,94,168,68,44
1395,2022-03-12,7.383333333333334,409,443,2022-03-12T03:33:30.000,99,200,110,34
1396,2022-03-13,6.933333333333334,387,416,2022-03-13T03:52:00.000,104,183,100,29
1397,2022-03-14,8.783333333333333,484,527,2022-03-14T00:57:30.000,96,221,167,43
1398,2022-03-15,7.533333333333333,409,452,2022-03-15T01:34:00.000,88,224,97,43
1399,2022-03-16,6.85,368,411,2022-03-16T02:00:00.000,101,169,98,43
1400,2022-03-17,7.35,405,441,2022-03-17T01:42:00.000,76,186,143,36
1401,2022-03-18,7.55,402,453,2022-03-18T01:49:00.000,94,183,125,51
1402,2022-03-19,6.133333333333334,334,368,2022-03-19T03:11:00.000,67,187,80,34
1403,2022-03-20,6.866666666666666,366,412,2022-03-20T03:19:00.000,89,157,120,46
1404,2022-03-21,8.033333333333333,429,482,2022-03-21T00:57:00.000,94,253,82,53
1405,2022-03-22,6.483333333333333,345,389,2022-03-22T02:08:30.000,90,167,88,44
1406,2022-03-23,7.333333333333333,391,440,2022-03-23T01:44:00.000,109,187,95,49
1407,2022-03-24,7.2,396,432,2022-03-24T02:15:00.000,79,192,125,36
1408,2022-03-25,6.766666666666667,363,406,2022-03-25T02:51:00.000,119,131,113,43
1409,2022-03-26,5.083333333333333,268,305,2022-03-26T05:32:00.000,64,191,13,37
1410,2022-03-27,7.966666666666667,435,478,2022-03-27T01:32:30.000,76,262,97,43
1411,2022-03-28,6.966666666666667,364,418,2022-03-28T03:11:00.000,75,181,108,54
1412,2022-03-29,7.466666666666667,400,448,2022-03-29T01:04:30.000,79,227,94,48
1413,2022-03-30,6.866666666666666,378,412,2022-03-30T02:38:00.000,98,180,100,34
1414,2022-03-31,6.683333333333334,348,401,2022-03-31T02:34:00.000,102,170,76,53
1415,2022-04-01,7.183333333333334,395,431,2022-04-01T02:45:00.000,105,157,133,36
1416,2022-04-02,6.85,375,411,2022-04-02T03:55:00.000,98,194,83,36
1417,2022-04-03,7.95,430,477,2022-04-03T02:27:00.000,108,222,100,47
1418,2022-04-04,6.683333333333334,373,401,2022-04-04T03:19:00.000,112,132,129,28
1419,2022-04-05,6.183333333333334,337,371,2022-04-05T02:44:00.000,108,128,101,34
1420,2022-04-06,7.316666666666666,397,439,2022-04-06T01:40:00.000,110,165,122,42
1421,2022-04-07,7.183333333333334,389,431,2022-04-07T01:23:00.000,79,227,83,42
1422,2022-04-08,6.9,367,414,2022-04-08T02:49:30.000,58,265,44,47
1423,2022-04-09,6.533333333333333,343,392,2022-04-09T03:22:00.000,84,186,73,49
1424,2022-04-10,5.4,261,324,2022-04-10T06:29:00.000,65,151,45,63
1425,2022-04-11,8.2,447,492,2022-04-11T01:45:30.000,110,215,122,45
1426,2022-04-12,6.733333333333333,348,404,2022-04-12T01:59:30.000,94,177,77,56
1427,2022-04-13,7.566666666666666,401,454,2022-04-13T01:39:30.000,93,199,109,53
1428,2022-04-14,6.366666666666666,327,382,2022-04-14T02:39:30.000,60,158,109,55
1429,2022-04-15,6.983333333333333,364,419,2022-04-15T02:37:00.000,54,243,67,55
1430,2022-04-16,7.65,429,459,2022-04-16T05:02:00.000,91,147,191,30
1431,2022-04-17,8.633333333333333,440,518,2022-04-17T03:40:00.000,60,294,86,78
1432,2022-04-18,7.35,375,441,2022-04-18T02:41:30.000,93,214,68,66
1433,2022-04-19,6.75,368,405,2022-04-19T02:19:00.000,63,216,89,37
1434,2022-04-20,6.633333333333334,359,398,2022-04-20T02:33:00.000,101,177,81,39
1435,2022-04-21,7.466666666666667,400,448,2022-04-21T01:45:00.000,80,208,112,48
1436,2022-04-22,6.766666666666667,365,406,2022-04-22T02:37:30.000,100,216,49,41
1437,2022-04-23,6.916666666666667,364,415,2022-04-23T02:51:00.000,80,201,83,51
1438,2022-04-24,5.833333333333333,316,350,2022-04-24T04:27:30.000,92,174,50,34
1439,2022-04-25,6.566666666666666,344,394,2022-04-25T02:56:30.000,123,123,98,50
1440,2022-04-26,6.65,358,399,2022-04-26T02:03:30.000,104,156,98,41
1441,2022-04-27,7.733333333333333,431,464,2022-04-27T02:04:00.000,121,188,122,33
1442,2022-04-28,6.616666666666666,368,397,2022-04-28T02:37:00.000,102,151,115,29
1443,2022-04-29,6.866666666666666,373,412,2022-04-29T00:48:00.000,79,214,80,39
1444,2022-04-30,6.616666666666666,359,397,2022-04-30T03:31:30.000,65,190,104,38
1445,2022-05-01,6.45,348,387,2022-05-01T01:01:00.000,69,215,64,39
1446,2022-05-02,7.066666666666666,365,424,2022-05-02T01:22:00.000,72,200,93,59
1447,2022-05-03,7.066666666666666,381,424,2022-05-03T01:59:00.000,95,189,97,43
1448,2022-05-04,7.466666666666667,400,448,2022-05-04T01:44:00.000,100,188,112,48
1449,2022-05-05,6.983333333333333,378,419,2022-05-05T01:56:30.000,108,168,102,41
1450,2022-05-06,6.516666666666667,355,391,2022-05-06T02:09:00.000,98,165,92,36
1451,2022-05-07,5.733333333333333,306,344,2022-05-07T02:37:30.000,75,164,67,38
1452,2022-05-08,7.333333333333333,401,440,2022-05-08T03:21:00.000,108,218,75,39
1453,2022-05-09,7.65,419,459,2022-05-09T02:15:00.000,99,211,109,40
1454,2022-05-10,6.966666666666667,386,418,2022-05-10T01:51:30.000,90,203,93,32
1455,2022-05-11,7.566666666666666,424,454,2022-05-11T00:49:30.000,131,193,100,30
1456,2022-05-12,7.066666666666666,389,424,2022-05-12T01:59:00.000,97,207,85,35
1457,2022-05-13,6.9,379,414,2022-05-13T02:43:00.000,90,190,99,35
1458,2022-05-14,6.966666666666667,364,418,2022-05-14T01:32:30.000,99,201,64,54
1459,2022-05-15,7.216666666666667,381,433,2022-05-15T01:02:30.000,78,252,51,52
1460,2022-05-16,6.816666666666666,367,409,2022-05-16T02:44:00.000,78,196,93,42
1461,2022-05-17,6.05,311,363,2022-05-17T02:59:00.000,61,182,68,52
1462,2022-05-18,6.45,357,387,2022-05-18T02:23:30.000,99,158,100,30
1463,2022-05-19,6.766666666666667,363,406,2022-05-19T02:26:30.000,108,133,122,43
1464,2022-05-21,3.933333333333333,217,236,2022-05-21T03:19:00.000,51,122,44,19
1465,2022-05-22,5.566666666666666,286,334,2022-05-22T01:32:00.000,76,142,68,48
1466,2022-05-23,8.35,445,501,2022-05-22T22:45:30.000,92,263,90,56
1467,2022-05-24,8.116666666666667,403,487,2022-05-23T22:40:00.000,57,327,19,84
1468,2022-05-25,4.066666666666666,222,244,2022-05-24T21:34:30.000,48,105,69,22
1469,2022-05-26,9.583333333333334,513,575,2022-05-25T20:09:30.000,97,343,73,62
1470,2022-05-27,6.983333333333333,377,419,2022-05-27T00:17:00.000,101,146,130,42
1471,2022-05-28,7.95,426,477,2022-05-28T00:17:00.000,170,137,119,51
1472,2022-05-29,5.916666666666667,329,355,2022-05-29T00:10:00.000,96,120,113,26
1473,2022-05-30,6.2,343,372,2022-05-29T23:46:00.000,84,184,75,29
1474,2022-05-31,7.933333333333334,420,476,2022-05-30T23:31:00.000,121,178,121,56
1475,2022-06-01,7.566666666666666,387,454,2022-06-01T01:36:30.000,93,207,87,67
1476,2022-06-02,7.166666666666667,362,430,2022-06-02T01:13:00.000,76,194,92,68
1477,2022-06-03,5.133333333333334,262,308,2022-06-03T01:29:30.000,69,125,68,46
1478,2022-06-04,8.183333333333334,423,491,2022-06-04T01:09:30.000,108,245,70,68
1479,2022-06-05,7.783333333333333,397,467,2022-06-05T02:14:30.000,83,223,91,70
1480,2022-06-06,7.433333333333334,385,446,2022-06-06T01:44:00.000,99,207,79,61
1481,2022-06-08,7.183333333333334,373,431,2022-06-07T21:08:30.000,84,193,96,58
1482,2022-06-09,7.816666666666666,439,469,2022-06-09T01:12:00.000,100,215,124,30
1483,2022-06-10,5.966666666666667,319,358,2022-06-10T01:36:00.000,73,149,97,39
1484,2022-06-11,6.3,352,378,2022-06-11T01:10:30.000,86,165,101,26
1485,2022-06-12,5.616666666666666,286,337,2022-06-12T04:59:00.000,67,183,36,51
1486,2022-06-13,8.366666666666667,440,502,2022-06-12T23:22:30.000,107,234,99,62
1487,2022-06-14,8.1,419,486,2022-06-13T23:54:30.000,118,187,114,67
1488,2022-06-15,6.916666666666667,372,415,2022-06-15T00:22:00.000,104,168,100,43
1489,2022-06-16,7.4,393,444,2022-06-16T00:16:00.000,98,184,111,51
1490,2022-06-17,7.116666666666666,378,427,2022-06-17T01:15:00.000,85,183,110,49
1491,2022-06-18,6.916666666666667,353,415,2022-06-18T01:31:30.000,82,190,81,62
1492,2022-06-19,6.716666666666667,343,403,2022-06-19T01:52:00.000,89,158,96,60
1493,2022-06-20,9.033333333333333,461,542,2022-06-19T23:35:00.000,105,246,110,81
1494,2022-06-21,6.55,353,393,2022-06-21T02:05:00.000,69,199,85,40
1495,2022-06-22,7.366666666666666,389,442,2022-06-22T01:59:30.000,78,206,105,53
1496,2022-06-23,7.416666666666667,391,445,2022-06-23T02:13:30.000,65,199,127,54
1497,2022-06-24,7.15,381,429,2022-06-24T02:16:30.000,66,200,115,48
1498,2022-06-25,7.65,412,459,2022-06-25T02:01:00.000,95,211,106,47
1499,2022-06-26,6.433333333333334,336,386,2022-06-26T05:30:00.000,99,174,63,50
1500,2022-06-27,7.866666666666666,417,472,2022-06-27T01:17:30.000,98,206,113,55
1501,2022-06-28,8.0,413,480,2022-06-28T01:31:00.000,102,189,122,67
1502,2022-06-29,8.033333333333333,437,482,2022-06-29T01:52:30.000,78,233,126,45
1503,2022-06-30,7.5,403,450,2022-06-30T02:05:00.000,103,194,106,47
1504,2022-07-01,6.7,366,402,2022-07-01T01:40:30.000,93,198,75,36
1505,2022-07-02,6.033333333333333,327,362,2022-07-02T06:03:00.000,97,135,95,35
1506,2022-07-03,7.233333333333333,395,434,2022-07-03T03:14:00.000,87,200,108,39
1507,2022-07-04,6.133333333333334,333,368,2022-07-04T04:50:30.000,69,178,86,35
1508,2022-07-05,6.866666666666666,367,412,2022-07-05T01:36:00.000,80,175,112,45
1509,2022-07-06,7.083333333333333,372,425,2022-07-06T02:03:00.000,59,217,96,53
1510,2022-07-07,8.216666666666667,441,493,2022-07-07T01:36:30.000,104,204,133,52
1511,2022-07-08,7.2,386,432,2022-07-08T01:13:30.000,74,233,79,46
1512,2022-07-09,6.483333333333333,336,389,2022-07-09T02:09:00.000,90,167,79,53
1513,2022-07-10,7.0,367,420,2022-07-10T01:33:00.000,91,188,88,53
1514,2022-07-11,6.516666666666667,344,391,2022-07-11T01:56:30.000,45,193,106,47
1515,2022-07-12,6.333333333333333,336,380,2022-07-12T01:49:00.000,64,179,93,44
1516,2022-07-13,7.383333333333334,392,443,2022-07-13T02:35:00.000,90,186,116,51
1517,2022-07-14,6.733333333333333,368,404,2022-07-14T01:58:30.000,81,201,86,36
1518,2022-07-15,6.283333333333333,336,377,2022-07-15T01:48:00.000,50,200,86,41
1519,2022-07-16,8.25,441,495,2022-07-16T00:57:30.000,112,257,72,54
1520,2022-07-17,6.45,315,387,2022-07-17T04:24:00.000,42,195,78,72
1521,2022-07-18,6.85,356,411,2022-07-18T02:42:30.000,88,179,89,55
1522,2022-07-19,6.583333333333333,348,395,2022-07-19T01:35:30.000,70,178,100,47
1523,2022-07-20,6.316666666666666,346,379,2022-07-20T02:38:00.000,70,161,115,33
1524,2022-07-21,8.583333333333334,459,515,2022-07-21T00:24:30.000,121,208,130,56
1525,2022-07-22,5.866666666666666,302,352,2022-07-22T02:26:00.000,89,143,70,50
1526,2022-07-23,6.716666666666667,351,403,2022-07-23T05:36:00.000,46,267,38,52
1527,2022-07-24,8.15,443,489,2022-07-24T03:24:00.000,81,272,90,46
1528,2022-07-25,8.15,430,489,2022-07-25T00:45:30.000,47,256,127,59
1529,2022-07-26,6.85,339,411,2022-07-26T01:45:00.000,47,213,79,72
1530,2022-07-27,7.533333333333333,395,452,2022-07-27T01:44:30.000,99,168,128,57
1531,2022-07-28,6.716666666666667,359,403,2022-07-28T02:22:00.000,95,148,116,44
1532,2022-07-29,6.766666666666667,358,406,2022-07-29T00:49:00.000,55,202,101,48
1533,2022-07-30,4.383333333333334,242,263,2022-07-30T05:35:30.000,69,136,37,21
1534,2022-07-31,10.666666666666666,552,640,2022-07-30T23:24:00.000,81,318,153,88
1535,2022-08-01,6.816666666666666,362,409,2022-08-01T02:39:30.000,78,189,95,47
1536,2022-08-02,7.55,391,453,2022-08-02T01:11:30.000,75,230,86,62
1537,2022-08-03,6.783333333333333,347,407,2022-08-03T02:25:00.000,79,223,45,60
1538,2022-08-04,6.55,355,393,2022-08-04T01:32:00.000,89,162,104,38
1539,2022-08-05,7.0,387,420,2022-08-05T01:34:00.000,83,188,116,33
1540,2022-08-06,6.85,379,411,2022-08-06T01:04:00.000,108,181,90,32
1541,2022-08-07,6.766666666666667,368,406,2022-08-07T03:03:00.000,94,175,99,38
1542,2022-08-08,7.966666666666667,434,478,2022-08-08T00:55:00.000,106,178,150,44
1543,2022-08-09,7.216666666666667,404,433,2022-08-09T00:51:00.000,89,206,109,29
1544,2022-08-10,8.033333333333333,410,482,2022-08-10T01:39:30.000,80,242,88,72
1545,2022-08-11,7.416666666666667,395,445,2022-08-11T01:26:30.000,78,243,74,50
1546,2022-08-12,6.716666666666667,345,403,2022-08-12T00:51:30.000,77,198,70,58
1547,2022-08-13,7.016666666666667,378,421,2022-08-13T04:18:00.000,77,224,77,43
1548,2022-08-14,6.65,358,399,2022-08-14T03:12:30.000,64,221,73,41
1549,2022-08-15,7.083333333333333,372,425,2022-08-15T02:32:00.000,75,165,132,53
1550,2022-08-16,6.366666666666666,351,382,2022-08-16T02:02:00.000,81,161,109,31
1551,2022-08-17,7.05,382,423,2022-08-17T02:45:00.000,58,226,98,41
1552,2022-08-18,6.9,357,414,2022-08-18T02:22:00.000,94,185,78,57
1553,2022-08-19,6.983333333333333,372,419,2022-08-19T03:11:00.000,71,213,88,47
1554,2022-08-20,6.633333333333334,361,398,2022-08-20T04:10:30.000,92,177,92,37
1555,2022-08-21,7.1,378,426,2022-08-21T04:41:00.000,68,224,86,48
1556,2022-08-22,7.466666666666667,402,448,2022-08-22T00:46:00.000,90,215,97,46
1557,2022-08-23,6.916666666666667,370,415,2022-08-23T01:38:30.000,72,213,85,45
1558,2022-08-24,7.383333333333334,381,443,2022-08-24T01:42:00.000,88,201,92,62
1559,2022-08-25,7.633333333333334,416,458,2022-08-25T01:54:30.000,101,211,104,42
1560,2022-08-26,6.933333333333334,359,416,2022-08-26T02:29:30.000,92,206,61,57
1561,2022-08-27,5.316666666666666,278,319,2022-08-27T06:47:30.000,54,174,50,41
1562,2022-08-28,8.633333333333333,430,518,2022-08-27T23:47:30.000,121,255,54,88
1563,2022-08-29,8.2,450,492,2022-08-28T23:09:30.000,114,208,128,42
1564,2022-08-30,7.933333333333334,435,476,2022-08-29T23:47:00.000,86,245,104,41
1565,2022-08-31,8.3,451,498,2022-08-30T23:19:00.000,65,276,110,47
1566,2022-09-01,7.5,390,450,2022-09-01T00:37:00.000,113,190,87,60
1567,2022-09-02,6.3,340,378,2022-09-02T01:24:00.000,73,184,83,38
1568,2022-09-03,8.966666666666667,474,538,2022-09-03T00:20:00.000,101,293,80,64
1569,2022-09-04,6.133333333333334,331,368,2022-09-03T21:45:00.000,90,223,18,37
1570,2022-09-05,9.0,478,540,2022-09-04T23:07:00.000,96,275,107,62
1571,2022-09-06,6.883333333333334,371,413,2022-09-06T01:03:00.000,68,207,96,42
1572,2022-09-07,8.133333333333333,446,488,2022-09-06T23:43:00.000,71,289,86,42
1573,2022-09-08,7.016666666666667,390,421,2022-09-08T00:53:30.000,68,231,91,31
1574,2022-09-09,6.85,362,411,2022-09-09T03:26:30.000,95,160,107,49
1575,2022-09-10,9.483333333333333,474,569,2022-09-10T02:44:00.000,96,299,79,95
1576,2022-09-11,7.016666666666667,374,421,2022-09-11T04:48:30.000,73,197,104,47
1577,2022-09-12,7.366666666666666,392,442,2022-09-12T01:03:00.000,87,217,88,50
1578,2022-09-13,6.416666666666667,351,385,2022-09-13T01:51:00.000,87,159,105,34
1579,2022-09-14,6.883333333333334,366,413,2022-09-14T02:21:00.000,91,195,80,47
1580,2022-09-15,7.183333333333334,382,431,2022-09-15T00:59:00.000,89,197,96,49
1581,2022-09-16,7.016666666666667,370,421,2022-09-16T02:37:30.000,90,212,68,51
1582,2022-09-17,5.65,290,339,2022-09-17T02:25:30.000,73,155,62,49
1583,2022-09-18,8.45,443,507,2022-09-18T02:26:30.000,112,170,161,64
1584,2022-09-19,7.816666666666666,422,469,2022-09-19T01:21:00.000,118,208,96,47
1585,2022-09-20,6.433333333333334,353,386,2022-09-20T01:58:00.000,68,206,79,33
1586,2022-09-21,8.233333333333333,443,494,2022-09-21T01:14:30.000,117,205,121,51
1587,2022-09-22,7.466666666666667,387,448,2022-09-22T02:02:00.000,77,225,85,61
1588,2022-09-23,7.483333333333333,392,449,2022-09-23T02:09:30.000,75,209,108,57
1589,2022-09-24,7.3,384,438,2022-09-24T04:07:00.000,88,244,52,54
1590,2022-09-25,8.316666666666666,433,499,2022-09-25T04:29:00.000,100,264,69,66
1591,2022-09-26,6.433333333333334,337,386,2022-09-26T02:29:00.000,60,204,73,49
1592,2022-09-27,6.8,349,408,2022-09-27T02:05:00.000,78,180,91,59
1593,2022-09-28,7.566666666666666,406,454,2022-09-28T02:22:30.000,98,209,99,48
1594,2022-09-29,7.116666666666666,373,427,2022-09-29T02:33:00.000,96,151,126,54
1595,2022-09-30,7.183333333333334,398,431,2022-09-30T02:35:00.000,112,173,113,33
1596,2022-10-01,7.966666666666667,420,478,2022-10-01T05:03:00.000,120,209,91,58
1597,2022-10-02,8.716666666666667,438,523,2022-10-02T05:20:00.000,116,224,98,85
1598,2022-10-03,6.883333333333334,366,413,2022-10-03T03:02:00.000,67,216,83,47
1599,2022-10-04,5.8,322,348,2022-10-04T03:21:00.000,59,176,87,26
1600,2022-10-05,7.016666666666667,385,421,2022-10-05T02:42:00.000,80,185,120,36
1601,2022-10-06,6.766666666666667,364,406,2022-10-06T03:06:00.000,97,173,94,42
1602,2022-10-07,7.066666666666666,391,424,2022-10-07T02:23:30.000,63,228,100,33
1603,2022-10-08,7.583333333333333,388,455,2022-10-08T03:47:00.000,90,199,99,67
1604,2022-10-09,6.133333333333334,327,368,2022-10-09T05:36:00.000,74,211,42,41
1605,2022-10-10,7.116666666666666,374,427,2022-10-10T02:27:30.000,78,206,90,53
1606,2022-10-11,6.183333333333334,330,371,2022-10-11T02:08:30.000,75,177,78,41
1607,2022-10-12,7.616666666666666,428,457,2022-10-12T02:42:00.000,98,255,75,29
1608,2022-10-13,6.516666666666667,348,391,2022-10-13T02:13:00.000,63,205,80,43
1609,2022-10-14,6.783333333333333,354,407,2022-10-14T04:56:30.000,83,177,94,53
1610,2022-10-15,7.316666666666666,396,439,2022-10-15T03:44:30.000,74,196,126,43
1611,2022-10-16,7.75,405,465,2022-10-16T03:24:00.000,75,294,36,60
1612,2022-10-17,8.65,460,519,2022-10-17T00:24:30.000,91,252,117,59
1613,2022-10-18,6.0,320,360,2022-10-17T23:28:30.000,62,218,40,40
1614,2022-10-19,6.75,354,405,2022-10-19T03:06:00.000,112,165,77,51
1615,2022-10-20,5.9,314,354,2022-10-20T02:05:00.000,60,194,60,40
1616,2022-10-21,7.2,375,432,2022-10-21T02:40:00.000,80,184,111,57
1617,2022-10-22,7.2,386,432,2022-10-22T03:52:00.000,92,188,106,46
1618,2022-10-23,8.233333333333333,415,494,2022-10-23T04:09:00.000,96,274,45,79
1619,2022-10-24,7.266666666666667,399,436,2022-10-24T02:26:00.000,108,203,88,37
1620,2022-10-25,6.183333333333334,330,371,2022-10-25T02:53:00.000,80,169,81,41
1621,2022-10-26,7.35,397,441,2022-10-26T02:18:00.000,113,202,82,44
1622,2022-10-27,7.2,370,432,2022-10-27T02:28:30.000,70,254,46,62
1623,2022-10-28,6.683333333333334,371,401,2022-10-28T02:31:00.000,88,216,67,30
1624,2022-10-29,7.733333333333333,415,464,2022-10-28T23:44:30.000,55,276,84,49
1625,2022-10-30,8.066666666666666,428,484,2022-10-30T02:27:00.000,88,267,73,56
1626,2022-10-31,6.416666666666667,329,385,2022-10-31T03:16:00.000,72,209,48,56
1627,2022-11-01,5.833333333333333,307,350,2022-11-01T03:28:00.000,58,180,69,43
1628,2022-11-02,7.25,384,435,2022-11-02T02:41:00.000,115,193,76,51
1629,2022-11-03,7.75,395,465,2022-11-03T02:28:00.000,100,223,72,70
1630,2022-11-04,5.866666666666666,323,352,2022-11-04T02:46:00.000,94,140,89,29
1631,2022-11-05,7.35,394,441,2022-11-05T00:38:00.000,88,184,122,47
1632,2022-11-06,9.083333333333334,454,545,2022-11-05T23:09:00.000,66,303,85,91
1633,2022-11-07,8.183333333333334,430,491,2022-11-07T00:06:00.000,94,222,114,61
1634,2022-11-08,6.2,340,372,2022-11-08T02:22:00.000,82,200,58,32
1635,2022-11-09,6.6,363,396,2022-11-09T02:20:00.000,86,171,106,33
1636,2022-11-10,6.783333333333333,356,407,2022-11-10T02:12:00.000,87,198,71,51
1637,2022-11-11,6.683333333333334,355,401,2022-11-11T02:35:30.000,85,204,66,46
1638,2022-11-12,7.133333333333334,360,428,2022-11-12T06:51:00.000,72,238,50,68
1639,2022-11-14,7.183333333333334,376,431,2022-11-14T02:33:00.000,87,228,61,55
1640,2022-11-15,6.35,349,381,2022-11-15T02:18:00.000,75,195,79,32
1641,2022-11-16,7.533333333333333,392,452,2022-11-16T02:13:00.000,64,241,87,60
1642,2022-11-17,7.316666666666666,395,439,2022-11-17T02:26:00.000,92,218,85,44
1643,2022-11-18,6.85,365,411,2022-11-18T02:26:30.000,63,221,81,46
1644,2022-11-19,6.583333333333333,326,395,2022-11-19T08:56:00.000,47,266,13,69
1645,2022-11-20,5.7,312,342,2022-11-20T06:52:00.000,68,186,58,30
1646,2022-11-21,6.716666666666667,368,403,2022-11-21T03:23:30.000,79,171,118,35
1647,2022-11-22,6.166666666666667,323,370,2022-11-22T03:02:30.000,71,196,56,47
1648,2022-11-23,4.633333333333334,245,278,2022-11-23T03:56:00.000,53,118,74,33
1649,2022-11-24,7.983333333333333,393,479,2022-11-24T00:44:30.000,91,201,101,86
1650,2022-11-25,7.433333333333334,405,446,2022-11-25T01:12:00.000,89,194,122,41
1651,2022-11-26,6.366666666666666,338,382,2022-11-26T01:32:00.000,100,176,62,44
1652,2022-11-27,7.583333333333333,409,455,2022-11-27T00:59:00.000,98,188,123,46
1653,2022-11-28,4.2,231,252,2022-11-28T03:58:00.000,68,110,53,21
1654,2022-11-29,6.816666666666666,362,409,2022-11-29T02:32:30.000,97,185,80,47
1655,2022-11-30,6.75,368,405,2022-11-30T02:58:30.000,75,204,89,37
1656,2022-12-01,5.816666666666666,320,349,2022-12-01T02:27:00.000,56,183,81,29
1657,2022-12-02,7.166666666666667,396,430,2022-12-02T02:54:00.000,118,154,124,34
1658,2022-12-03,6.05,328,363,2022-12-03T03:21:30.000,93,160,75,35
1659,2022-12-04,6.333333333333333,344,380,2022-12-04T03:18:00.000,64,187,93,36
1660,2022-12-05,6.433333333333334,340,386,2022-12-05T02:10:30.000,74,195,71,46
1661,2022-12-06,7.916666666666667,409,475,2022-12-06T01:06:00.000,99,220,90,66
1662,2022-12-07,6.616666666666666,346,397,2022-12-07T02:42:00.000,91,161,94,51
1663,2022-12-08,6.766666666666667,361,406,2022-12-08T02:31:00.000,78,203,80,45
1664,2022-12-09,7.466666666666667,399,448,2022-12-09T02:14:00.000,103,210,86,49
1665,2022-12-10,5.216666666666667,260,313,2022-12-10T07:00:30.000,60,170,30,53
1666,2022-12-11,7.016666666666667,374,421,2022-12-11T02:57:30.000,68,203,103,47
1667,2022-12-12,6.75,361,405,2022-12-12T02:58:00.000,87,197,77,44
1668,2022-12-13,6.366666666666666,339,382,2022-12-13T02:27:30.000,90,168,81,43
1669,2022-12-14,7.316666666666666,404,439,2022-12-14T02:27:00.000,57,250,97,35
1670,2022-12-15,6.566666666666666,343,394,2022-12-15T01:53:00.000,85,187,71,51
1671,2022-12-16,8.2,446,492,2022-12-16T01:17:00.000,89,235,122,46
1672,2022-12-17,6.383333333333334,338,383,2022-12-17T03:26:00.000,63,185,90,45
1673,2022-12-18,6.716666666666667,373,403,2022-12-18T03:14:30.000,91,184,98,30
1674,2022-12-19,8.016666666666667,436,481,2022-12-19T01:55:00.000,120,188,128,45
1675,2022-12-20,7.3,399,438,2022-12-20T03:54:30.000,98,212,89,39
1676,2022-12-21,6.866666666666666,381,412,2022-12-21T04:10:00.000,101,198,82,31
1677,2022-12-22,5.9,318,354,2022-12-22T02:47:30.000,85,166,67,36
1678,2022-12-23,7.316666666666666,378,439,2022-12-23T00:55:00.000,75,278,25,61
1679,2022-12-24,6.066666666666666,319,364,2022-12-24T02:05:00.000,65,185,69,45
1680,2022-12-25,4.0,209,240,2022-12-25T00:31:00.000,48,142,19,31
1681,2022-12-26,7.783333333333333,428,467,2022-12-26T00:58:00.000,93,221,114,39
1682,2022-12-27,7.616666666666666,409,457,2022-12-27T01:09:30.000,78,232,99,48
1683,2022-12-28,7.166666666666667,391,430,2022-12-28T01:27:30.000,93,194,104,39
1684,2022-12-29,5.066666666666666,282,304,2022-12-29T01:40:00.000,82,128,72,22
1685,2022-12-30,8.333333333333334,430,500,2022-12-29T23:58:00.000,75,274,81,70
1686,2022-12-31,7.066666666666666,378,424,2022-12-31T03:33:00.000,73,226,79,46
1687,2023-01-01,5.166666666666667,271,310,2023-01-01T05:13:00.000,65,164,42,39
1688,2023-01-02,8.066666666666666,436,484,2023-01-02T01:50:00.000,49,280,107,48
1689,2023-01-03,6.933333333333334,362,416,2023-01-03T02:44:00.000,70,190,102,54
1690,2023-01-04,7.183333333333334,379,431,2023-01-04T02:56:30.000,104,183,92,52
1691,2023-01-05,6.666666666666667,351,400,2023-01-05T01:58:00.000,73,178,100,49
1692,2023-01-06,7.166666666666667,392,430,2023-01-06T02:20:00.000,59,238,95,38
1693,2023-01-07,7.833333333333333,416,470,2023-01-07T03:13:00.000,96,211,109,54
1694,2023-01-08,6.85,369,411,2023-01-08T04:32:00.000,80,184,105,42
1695,2023-01-09,7.75,417,465,2023-01-09T01:54:00.000,65,228,124,48
1696,2023-01-10,6.55,346,393,2023-01-10T02:20:00.000,69,219,58,47
1697,2023-01-11,7.45,403,447,2023-01-11T02:31:30.000,88,206,109,44
1698,2023-01-12,5.983333333333333,306,359,2023-01-12T02:51:30.000,46,190,70,53
1699,2023-01-13,6.833333333333333,359,410,2023-01-13T02:49:00.000,78,188,93,51
1700,2023-01-14,8.566666666666666,451,514,2023-01-14T02:12:00.000,96,252,103,63
1701,2023-01-15,7.45,369,447,2023-01-15T03:27:30.000,103,185,81,78
1702,2023-01-16,7.566666666666666,390,454,2023-01-16T04:49:00.000,98,189,103,64
1703,2023-01-17,5.95,314,357,2023-01-17T02:49:00.000,63,179,72,43
1704,2023-01-18,7.6,406,456,2023-01-18T02:36:00.000,84,226,96,50
1705,2023-01-19,6.216666666666667,326,373,2023-01-19T02:31:00.000,84,165,77,47
1706,2023-01-20,7.5,385,450,2023-01-20T02:18:30.000,107,179,99,65
1707,2023-01-21,5.233333333333333,267,314,2023-01-21T10:44:30.000,85,159,23,47
1708,2023-01-22,8.716666666666667,479,523,2023-01-22T00:30:00.000,86,261,132,44
1709,2023-01-23,5.833333333333333,302,350,2023-01-23T03:47:00.000,101,129,72,48
1710,2023-01-24,5.666666666666667,294,340,2023-01-24T02:56:30.000,46,181,67,46
1711,2023-01-25,6.35,323,381,2023-01-25T03:18:30.000,79,201,43,58
1712,2023-01-26,4.8,266,288,2023-01-26T04:02:00.000,47,160,59,22
1713,2023-01-27,6.85,372,411,2023-01-27T02:40:00.000,69,218,85,39
1714,2023-01-28,6.983333333333333,371,419,2023-01-28T04:36:00.000,108,176,87,48
1715,2023-01-29,5.866666666666666,307,352,2023-01-29T03:09:30.000,71,181,55,45
1716,2023-01-30,6.05,328,363,2023-01-30T02:33:00.000,65,177,86,35
1717,2023-01-31,6.05,322,363,2023-01-31T02:22:30.000,83,169,70,41
1718,2023-02-01,6.216666666666667,323,373,2023-02-01T02:58:00.000,55,197,71,50
1719,2023-02-02,5.9,293,354,2023-02-02T02:26:30.000,58,219,16,61
1720,2023-02-03,7.416666666666667,395,445,2023-02-03T01:12:00.000,76,263,56,50
1721,2023-02-04,7.05,377,423,2023-02-04T01:00:30.000,90,202,85,46
1722,2023-02-05,6.583333333333333,351,395,2023-02-05T03:17:00.000,102,204,45,44
1723,2023-02-08,6.35,340,381,2023-02-08T03:09:00.000,78,204,58,41
1724,2023-02-09,7.25,376,435,2023-02-09T01:01:30.000,105,192,79,59
1725,2023-02-10,6.133333333333334,307,368,2023-02-10T03:06:30.000,93,163,51,61
1726,2023-02-11,6.316666666666666,315,379,2023-02-11T03:12:00.000,59,198,58,64
1727,2023-02-13,8.066666666666666,432,484,2023-02-13T01:06:00.000,96,256,80,52
1728,2023-02-14,6.266666666666667,327,376,2023-02-14T02:13:00.000,95,154,78,49
1729,2023-02-15,7.116666666666666,373,427,2023-02-15T02:06:00.000,88,205,80,54
1730,2023-02-16,6.6,342,396,2023-02-16T00:47:30.000,55,230,57,54
1731,2023-02-17,5.85,295,351,2023-02-17T02:41:00.000,72,210,13,56
1732,2023-02-18,6.55,336,393,2023-02-18T03:02:30.000,92,196,48,57
1733,2023-02-19,4.116666666666666,214,247,2023-02-19T06:52:00.000,53,136,25,33
1734,2023-02-20,8.133333333333333,419,488,2023-02-20T00:36:00.000,109,228,82,69
1735,2023-02-21,7.333333333333333,402,440,2023-02-21T01:28:30.000,82,221,99,38
1736,2023-02-22,6.116666666666666,326,367,2023-02-22T03:06:30.000,70,181,75,41
1737,2023-02-24,6.166666666666667,318,370,2023-02-24T03:35:30.000,56,221,41,52
1738,2023-02-25,4.616666666666666,238,277,2023-02-25T05:49:00.000,58,127,53,39
1739,2023-02-26,6.2,342,372,2023-02-26T02:50:00.000,87,191,64,30
1740,2023-02-27,7.733333333333333,409,464,2023-02-27T01:49:30.000,91,238,80,55
1741,2023-02-28,6.333333333333333,333,380,2023-02-28T02:20:30.000,66,201,66,47
1742,2023-03-01,7.166666666666667,362,430,2023-03-01T02:15:00.000,88,195,79,68
1743,2023-03-02,8.1,431,486,2023-03-02T01:32:30.000,85,257,89,55
1744,2023-03-03,5.133333333333334,270,308,2023-03-03T03:16:00.000,87,133,50,38
1745,2023-03-04,6.033333333333333,316,362,2023-03-04T04:29:00.000,66,184,66,46
1746,2023-03-05,7.533333333333333,404,452,2023-03-05T01:57:00.000,116,176,112,48
1747,2023-03-06,6.216666666666667,334,373,2023-03-06T02:53:00.000,46,203,85,39
1748,2023-03-07,6.183333333333334,318,371,2023-03-07T02:06:00.000,40,242,36,53
1749,2023-03-08,7.066666666666666,342,424,2023-03-08T02:43:00.000,74,218,50,82
1750,2023-03-09,6.066666666666666,309,364,2023-03-09T02:50:30.000,57,221,31,55
1751,2023-03-11,5.95,316,357,2023-03-11T02:46:00.000,73,159,84,41
1752,2023-03-12,6.766666666666667,366,406,2023-03-12T04:45:00.000,69,210,87,40
1753,2023-03-13,6.9,361,414,2023-03-13T02:09:00.000,82,224,55,53
1754,2023-03-14,6.866666666666666,373,412,2023-03-14T01:23:00.000,67,199,107,39
1755,2023-03-15,6.883333333333334,372,413,2023-03-15T02:06:00.000,117,174,81,41
1756,2023-03-16,7.25,387,435,2023-03-16T01:46:30.000,75,212,100,48
1757,2023-03-17,6.566666666666666,364,394,2023-03-17T01:22:00.000,137,131,96,30
1758,2023-03-18,4.15,220,249,2023-03-18T07:53:30.000,62,111,47,29
1759,2023-03-19,5.366666666666666,292,322,2023-03-19T05:37:30.000,53,201,38,30
1760,2023-03-20,8.166666666666666,432,490,2023-03-20T01:25:00.000,59,233,140,58
1761,2023-03-21,6.8,339,408,2023-03-21T01:50:30.000,88,213,38,69
1762,2023-03-22,6.15,323,369,2023-03-22T03:32:30.000,104,158,61,46
1763,2023-03-23,5.85,315,351,2023-03-23T03:18:00.000,78,174,63,36
1764,2023-03-24,7.883333333333334,419,473,2023-03-24T01:17:00.000,99,200,120,54
1765,2023-03-25,7.1,386,426,2023-03-25T05:25:00.000,76,224,86,40
1766,2023-03-26,5.55,303,333,2023-03-26T05:51:00.000,66,159,78,30
1767,2023-03-27,5.866666666666666,305,352,2023-03-27T03:08:00.000,53,196,56,47
1768,2023-03-28,7.216666666666667,398,433,2023-03-28T01:23:30.000,45,244,109,35
1769,2023-03-29,7.533333333333333,408,452,2023-03-29T01:45:30.000,81,281,46,44
1770,2023-03-30,6.9,380,414,2023-03-30T01:38:30.000,64,242,74,34
1771,2023-03-31,6.383333333333334,353,383,2023-03-31T01:49:30.000,66,220,67,30
1772,2023-04-01,6.05,324,363,2023-04-01T02:51:30.000,76,175,73,39
1773,2023-04-02,3.7333333333333334,197,224,2023-04-02T07:09:00.000,46,123,28,27
1774,2023-04-03,8.533333333333333,461,512,2023-04-03T00:32:00.000,109,247,105,51
1775,2023-04-04,6.916666666666667,365,415,2023-04-04T01:44:30.000,68,225,72,50
1776,2023-04-05,7.466666666666667,394,448,2023-04-05T02:16:30.000,85,214,95,54
1777,2023-04-06,5.433333333333334,287,326,2023-04-06T03:35:00.000,76,176,35,39
1778,2023-04-07,6.833333333333333,348,410,2023-04-07T03:32:00.000,90,177,81,62
1779,2023-04-08,3.4833333333333334,175,209,2023-04-08T06:22:30.000,52,72,51,34
1780,2023-04-09,7.05,354,423,2023-04-09T03:00:00.000,75,224,55,69
1781,2023-04-10,6.6,356,396,2023-04-10T03:32:00.000,96,166,94,40
1782,2023-04-11,6.433333333333334,357,386,2023-04-11T01:40:00.000,86,178,93,29
1783,2023-04-12,6.316666666666666,324,379,2023-04-12T03:21:30.000,77,186,61,55
1784,2023-04-13,5.1,269,306,2023-04-13T04:02:00.000,42,166,61,37
1785,2023-04-14,6.616666666666666,336,397,2023-04-14T02:16:30.000,77,210,49,61
1786,2023-04-15,5.3,266,318,2023-04-15T05:36:30.000,58,164,44,52
1787,2023-04-16,7.433333333333334,400,446,2023-04-16T03:37:00.000,98,204,98,46
1788,2023-04-17,7.383333333333334,393,443,2023-04-17T02:17:00.000,82,218,93,50
1789,2023-04-18,6.8,365,408,2023-04-18T01:44:00.000,114,185,66,43
1790,2023-04-19,7.6,423,456,2023-04-19T01:49:00.000,92,213,118,33
1791,2023-04-20,8.033333333333333,436,482,2023-04-20T01:47:30.000,89,220,127,46
1792,2023-04-21,6.533333333333333,361,392,2023-04-21T02:16:30.000,83,174,104,31
1793,2023-04-30,7.083333333333333,377,425,2023-04-30T04:22:00.000,116,160,101,48
1794,2023-05-01,6.483333333333333,339,389,2023-05-01T02:09:00.000,70,195,74,50
1795,2023-05-02,6.733333333333333,364,404,2023-05-02T01:13:30.000,47,245,72,40
1796,2023-05-03,7.433333333333334,394,446,2023-05-03T01:54:30.000,67,260,67,52
1797,2023-05-04,7.25,379,435,2023-05-04T02:09:30.000,84,239,56,56
1798,2023-05-05,7.3,398,438,2023-05-05T01:01:00.000,106,200,92,40
1799,2023-05-06,7.383333333333334,384,443,2023-05-06T03:29:00.000,111,185,88,59
1800,2023-05-07,7.033333333333333,370,422,2023-05-07T00:55:30.000,78,197,95,52
1801,2023-05-08,7.05,375,423,2023-05-08T02:15:00.000,70,229,76,48
1802,2023-05-09,7.133333333333334,365,428,2023-05-09T01:08:30.000,96,199,70,63
1803,2023-05-10,6.9,359,414,2023-05-10T01:24:30.000,89,217,53,55
1804,2023-05-11,6.616666666666666,353,397,2023-05-11T01:14:00.000,89,180,84,44
1805,2023-05-12,7.016666666666667,373,421,2023-05-12T01:01:30.000,81,224,68,48
1806,2023-05-13,7.1,378,426,2023-05-13T03:21:00.000,127,151,100,48
1807,2023-05-14,6.566666666666666,337,394,2023-05-14T02:56:30.000,52,224,61,57
1808,2023-05-15,7.8,408,468,2023-05-15T01:37:00.000,101,237,70,60
1809,2023-05-16,7.233333333333333,400,434,2023-05-16T01:40:00.000,79,223,98,34
1810,2023-05-17,7.783333333333333,423,467,2023-05-17T01:31:00.000,95,248,80,44
1811,2023-05-18,7.183333333333334,393,431,2023-05-18T02:15:00.000,67,224,102,38
1812,2023-05-19,7.316666666666666,391,439,2023-05-19T01:23:00.000,66,212,113,48
1813,2023-05-20,9.05,497,543,2023-05-20T01:46:00.000,99,272,126,46
1814,2023-05-21,7.016666666666667,369,421,2023-05-21T03:17:30.000,43,266,60,52
1815,2023-05-22,7.266666666666667,395,436,2023-05-22T02:13:00.000,88,216,91,41
1816,2023-05-23,7.283333333333333,400,437,2023-05-23T01:28:00.000,70,204,126,37
1817,2023-05-24,7.666666666666667,374,460,2023-05-24T02:09:00.000,71,223,80,86
1818,2023-05-25,8.083333333333334,437,485,2023-05-25T01:08:30.000,104,201,132,48
1819,2023-05-26,6.916666666666667,358,415,2023-05-26T02:31:30.000,79,213,66,57
1820,2023-05-27,3.966666666666667,206,238,2023-05-27T07:39:00.000,56,123,27,32
1821,2023-05-28,8.15,431,489,2023-05-28T04:19:00.000,99,242,90,58
1822,2023-05-29,7.583333333333333,403,455,2023-05-29T03:01:00.000,105,208,90,52
1823,2023-05-30,6.683333333333334,355,401,2023-05-30T01:58:00.000,60,210,85,46
1824,2023-05-31,8.65,446,519,2023-05-31T00:47:00.000,64,265,117,73
1825,2023-06-01,6.8,374,408,2023-06-01T02:52:00.000,103,157,114,34
1826,2023-06-02,5.983333333333333,327,359,2023-06-02T03:42:00.000,87,169,71,32
1827,2023-06-03,6.516666666666667,338,391,2023-06-03T04:31:30.000,67,212,59,53
1828,2023-06-04,7.5,402,450,2023-06-04T02:59:00.000,100,183,119,48
1829,2023-06-05,6.916666666666667,372,415,2023-06-05T02:36:00.000,115,172,85,43
1830,2023-06-06,7.383333333333334,402,443,2023-06-06T01:27:30.000,85,289,28,41
1831,2023-06-07,7.4,395,444,2023-06-07T02:06:00.000,67,235,93,49
1832,2023-06-08,7.1,387,426,2023-06-08T01:59:00.000,77,210,100,39
1833,2023-06-09,8.333333333333334,423,500,2023-06-09T01:20:00.000,84,234,105,77
1834,2023-06-11,7.0,369,420,2023-06-11T04:55:00.000,102,194,73,51
1835,2023-06-12,8.083333333333334,441,485,2023-06-12T01:43:00.000,103,233,105,44
1836,2023-06-13,7.833333333333333,420,470,2023-06-13T01:48:00.000,107,232,81,50
1837,2023-06-14,6.183333333333334,328,371,2023-06-14T01:45:00.000,56,229,43,43
1838,2023-06-15,6.7,351,402,2023-06-15T01:16:00.000,97,187,67,51
1839,2023-06-16,6.966666666666667,348,418,2023-06-16T00:59:00.000,31,268,49,70
1840,2023-06-25,6.833333333333333,356,410,2023-06-25T04:07:00.000,74,171,111,54
1841,2023-06-26,7.416666666666667,385,445,2023-06-26T01:58:00.000,93,208,84,60
1842,2023-06-27,6.4,340,384,2023-06-27T02:22:00.000,66,185,89,44
1843,2023-06-28,7.3,389,438,2023-06-28T02:02:30.000,70,218,101,49
1844,2023-06-29,8.116666666666667,430,487,2023-06-29T00:48:00.000,65,311,54,57
1845,2023-06-30,7.483333333333333,391,449,2023-06-30T01:58:00.000,85,244,62,58
1846,2023-07-01,7.75,402,465,2023-07-01T01:51:00.000,79,229,94,63
1847,2023-07-02,8.2,412,492,2023-07-02T02:35:00.000,99,265,48,80
1848,2023-07-03,7.45,369,447,2023-07-03T02:08:30.000,93,249,27,78
1849,2023-07-04,9.0,466,540,2023-07-04T02:26:00.000,57,246,163,74
1850,2023-07-05,7.483333333333333,386,449,2023-07-05T01:42:30.000,70,225,91,63
1851,2023-07-06,6.75,0,405,2023-07-06T02:16:00.000,0,0,0,0
1852,2023-07-07,7.216666666666667,389,433,2023-07-07T03:00:00.000,121,150,118,44
1853,2023-07-08,7.833333333333333,400,470,2023-07-08T03:08:00.000,112,200,88,70
1854,2023-07-09,5.333333333333333,286,320,2023-07-09T04:04:30.000,94,122,70,34
1855,2023-07-10,8.4,448,504,2023-07-10T01:24:30.000,72,262,114,56
1856,2023-07-11,6.033333333333333,325,362,2023-07-11T03:24:30.000,89,155,81,37
1857,2023-07-12,7.05,351,423,2023-07-12T02:48:00.000,69,222,60,72
1858,2023-07-13,7.266666666666667,391,436,2023-07-13T02:22:00.000,67,229,95,45
1859,2023-07-14,7.383333333333334,374,443,2023-07-14T03:11:00.000,77,214,83,69
1860,2023-07-15,8.65,433,519,2023-07-15T04:30:30.000,94,291,48,86
1861,2023-07-16,6.966666666666667,372,418,2023-07-16T02:05:00.000,68,234,70,46
1862,2023-07-17,7.183333333333334,386,431,2023-07-17T02:23:00.000,90,233,63,45
1863,2023-07-18,6.683333333333334,335,401,2023-07-18T01:40:30.000,90,212,33,66
1864,2023-07-19,7.2,387,432,2023-07-19T02:21:00.000,91,234,62,45
1865,2023-07-20,7.0,377,420,2023-07-20T01:17:30.000,92,180,105,43
1866,2023-07-21,7.35,389,441,2023-07-21T02:10:00.000,95,195,99,52
1867,2023-07-22,6.616666666666666,339,397,2023-07-22T04:11:00.000,83,220,36,58
1868,2023-07-23,6.5,335,390,2023-07-23T03:24:00.000,62,171,102,55
1869,2023-07-24,7.883333333333334,423,473,2023-07-24T01:44:00.000,84,245,94,50
1870,2023-07-25,6.566666666666666,347,394,2023-07-25T02:15:00.000,108,161,78,47
1871,2023-07-26,7.233333333333333,384,434,2023-07-26T02:20:00.000,91,187,106,50
1872,2023-07-27,7.283333333333333,394,437,2023-07-27T02:16:30.000,105,215,74,43
1873,2023-07-28,7.65,393,459,2023-07-28T01:42:00.000,89,220,84,66
1874,2023-07-30,9.866666666666667,530,592,2023-07-30T02:16:00.000,117,325,88,62
1875,2023-07-31,6.516666666666667,355,391,2023-07-31T02:24:00.000,80,160,115,36
1876,2023-08-01,7.183333333333334,387,431,2023-08-01T01:35:00.000,117,171,99,44
1877,2023-08-02,7.383333333333334,393,443,2023-08-02T02:06:30.000,71,189,133,50
1878,2023-08-03,7.633333333333334,396,458,2023-08-03T02:27:30.000,86,224,86,62
1879,2023-08-04,6.116666666666666,323,367,2023-08-04T02:33:00.000,77,175,71,44
1880,2023-08-05,6.95,361,417,2023-08-05T03:58:30.000,55,188,118,56
1881,2023-08-06,7.983333333333333,422,479,2023-08-06T03:07:00.000,92,191,139,57
1882,2023-08-07,7.016666666666667,359,421,2023-08-07T01:59:00.000,82,197,80,62
1883,2023-08-08,6.316666666666666,335,379,2023-08-08T02:23:00.000,93,183,59,44
1884,2023-08-09,6.866666666666666,361,412,2023-08-09T02:24:30.000,70,176,115,51
1885,2023-08-10,6.666666666666667,353,400,2023-08-10T02:39:30.000,81,195,77,47
1886,2023-08-11,7.066666666666666,373,424,2023-08-11T02:10:00.000,72,216,85,51
1887,2023-08-12,8.166666666666666,428,490,2023-08-12T03:12:00.000,74,289,65,62
1888,2023-08-13,6.866666666666666,367,412,2023-08-13T03:14:00.000,96,150,121,45
1889,2023-08-14,8.066666666666666,409,484,2023-08-14T00:14:00.000,79,255,75,75
1890,2023-08-15,6.683333333333334,347,401,2023-08-15T01:50:00.000,48,260,39,54
1891,2023-08-16,7.25,370,435,2023-08-16T01:36:30.000,56,242,72,65
1892,2023-08-17,7.65,410,459,2023-08-17T01:18:00.000,77,257,76,49
1893,2023-08-18,6.55,338,393,2023-08-18T03:15:00.000,51,225,62,55
1894,2023-08-19,8.866666666666667,455,532,2023-08-19T03:20:30.000,83,295,77,77
1895,2023-08-20,8.45,441,507,2023-08-20T02:46:00.000,106,198,137,66
1896,2023-08-21,7.033333333333333,379,422,2023-08-21T01:46:30.000,59,213,107,43
1897,2023-08-22,7.033333333333333,371,422,2023-08-22T02:10:00.000,90,194,87,51
1898,2023-08-23,7.633333333333334,419,458,2023-08-23T01:42:00.000,96,197,126,39
1899,2023-08-24,7.666666666666667,412,460,2023-08-24T01:22:30.000,81,247,84,48
1900,2023-08-25,8.316666666666666,446,499,2023-08-25T01:19:30.000,92,250,104,53
1901,2023-08-26,8.016666666666667,399,481,2023-08-26T02:51:00.000,77,294,28,82
1902,2023-08-27,8.483333333333333,430,509,2023-08-27T02:27:00.000,100,254,76,79
1903,2023-08-28,8.216666666666667,432,493,2023-08-28T01:26:00.000,88,243,101,61
1904,2023-08-29,7.016666666666667,373,421,2023-08-29T01:48:00.000,75,245,53,48
1905,2023-08-30,7.9,407,474,2023-08-30T01:36:00.000,76,235,96,67
1906,2023-08-31,6.45,340,387,2023-08-31T03:24:00.000,56,181,103,47
1907,2023-09-01,7.266666666666667,387,436,2023-09-01T02:20:00.000,75,227,85,49
1908,2023-09-02,6.966666666666667,354,418,2023-09-02T04:47:00.000,90,204,60,64
1909,2023-09-03,6.75,350,405,2023-09-03T07:05:00.000,61,229,60,55
1910,2023-09-04,8.8,456,528,2023-09-04T03:26:30.000,106,264,86,72
1911,2023-09-05,6.2,334,372,2023-09-05T03:01:00.000,65,211,58,38
1912,2023-09-06,8.116666666666667,420,487,2023-09-06T02:12:30.000,106,212,102,67
1913,2023-09-07,7.166666666666667,394,430,2023-09-07T02:33:00.000,90,219,85,36
1914,2023-09-08,8.633333333333333,450,518,2023-09-08T03:11:30.000,69,286,95,68
1915,2023-09-09,7.433333333333334,382,446,2023-09-09T05:42:30.000,42,280,60,64
1916,2023-09-10,8.083333333333334,413,485,2023-09-10T03:10:30.000,72,252,89,72
1917,2023-09-11,6.7,330,402,2023-09-11T03:59:00.000,45,212,73,72
1918,2023-09-12,6.7,359,402,2023-09-12T02:30:00.000,65,222,72,43
1919,2023-09-13,6.983333333333333,392,419,2023-09-13T03:31:00.000,82,173,137,27
1920,2023-09-14,7.45,403,447,2023-09-14T02:35:00.000,83,238,82,44
1921,2023-09-16,6.3,317,378,2023-09-16T06:55:30.000,86,209,22,61
1922,2023-09-17,9.216666666666667,459,553,2023-09-17T02:43:00.000,84,325,50,94
1923,2023-09-18,6.283333333333333,324,377,2023-09-18T03:51:00.000,33,216,75,53
1924,2023-09-19,6.916666666666667,370,415,2023-09-19T02:08:30.000,71,227,72,45
1925,2023-09-20,7.366666666666666,363,442,2023-09-20T02:47:30.000,76,246,41,79
1926,2023-09-21,7.35,395,441,2023-09-21T02:01:30.000,61,240,94,46
1927,2023-09-22,7.55,410,453,2023-09-22T02:29:00.000,78,238,94,43
1928,2023-09-23,8.566666666666666,437,514,2023-09-23T03:33:00.000,100,243,94,77
1929,2023-09-24,7.983333333333333,436,479,2023-09-24T03:42:00.000,84,226,126,43
1930,2023-09-25,7.05,374,423,2023-09-25T02:50:00.000,78,207,89,49
1931,2023-09-26,6.183333333333334,339,371,2023-09-26T03:07:00.000,69,198,72,32
1932,2023-09-27,8.283333333333333,452,497,2023-09-27T02:12:00.000,86,239,127,45
1933,2023-09-28,7.5,399,450,2023-09-28T02:30:00.000,84,234,81,51
1934,2023-09-29,6.3,335,378,2023-09-29T03:08:00.000,65,224,46,43
1935,2023-09-30,7.15,397,429,2023-09-30T03:06:00.000,99,193,105,32
1936,2023-10-01,8.35,437,501,2023-10-01T03:50:00.000,106,191,140,64
1937,2023-10-02,7.566666666666666,409,454,2023-10-02T01:55:00.000,90,229,90,45
1938,2023-10-03,6.75,356,405,2023-10-03T02:32:30.000,55,231,70,49
1939,2023-10-04,7.616666666666666,414,457,2023-10-04T02:11:00.000,82,235,97,43
1940,2023-10-05,6.7,357,402,2023-10-05T03:24:30.000,69,199,89,45
1941,2023-10-06,4.533333333333333,240,272,2023-10-06T04:57:00.000,81,121,38,32
1942,2023-10-07,7.25,391,435,2023-10-07T05:11:00.000,51,271,69,44
1943,2023-10-08,8.166666666666666,433,490,2023-10-08T04:32:00.000,105,223,105,57
1944,2023-10-09,6.816666666666666,364,409,2023-10-09T02:45:00.000,72,190,102,45
1945,2023-10-10,6.816666666666666,345,409,2023-10-10T02:32:00.000,76,171,98,64
1946,2023-10-11,7.116666666666666,388,427,2023-10-11T02:46:00.000,103,162,123,39
1947,2023-10-12,7.25,395,435,2023-10-12T02:43:00.000,92,223,80,40
1948,2023-10-14,7.966666666666667,430,478,2023-10-14T02:03:00.000,105,209,116,48
1949,2023-10-15,7.166666666666667,388,430,2023-10-15T03:19:00.000,42,248,98,42
1950,2023-10-16,8.616666666666667,469,517,2023-10-16T03:40:00.000,83,272,114,48
1951,2023-10-17,8.383333333333333,443,503,2023-10-17T02:41:00.000,102,200,141,60
1952,2023-10-18,3.95,208,237,2023-10-18T02:03:00.000,35,142,31,29
1953,2023-10-19,8.233333333333333,422,494,2023-10-19T06:57:00.000,113,252,57,72
1954,2023-10-20,6.433333333333334,341,386,2023-10-20T08:12:00.000,52,237,52,45
1955,2023-10-21,6.9,339,414,2023-10-21T09:19:30.000,95,218,26,75
1956,2023-10-22,7.483333333333333,406,449,2023-10-22T08:35:00.000,88,247,71,43
1957,2023-10-24,10.366666666666667,528,622,2023-10-24T00:08:00.000,88,341,99,94
1958,2023-10-25,6.55,336,393,2023-10-25T03:02:00.000,67,199,70,57
1959,2023-10-26,8.083333333333334,425,485,2023-10-26T02:11:00.000,84,265,76,60
1960,2023-10-27,7.15,384,429,2023-10-27T02:04:00.000,79,241,64,45
1961,2023-10-28,8.366666666666667,440,502,2023-10-28T02:37:00.000,84,259,97,62
1962,2023-10-29,7.233333333333333,372,434,2023-10-29T03:37:30.000,79,228,65,62
1963,2023-10-30,7.633333333333334,426,458,2023-10-30T01:51:30.000,87,238,101,32
1964,2023-10-31,6.6,367,396,2023-10-31T02:37:00.000,42,220,105,29
1965,2023-11-01,7.25,394,435,2023-11-01T02:33:00.000,76,197,121,41
